Gll^Fp, Gll^Fp, Gll^Fp, Gll^Fp, Gll^Fp, Gll^Fp, Gs^Fms, Gs^Fms, Gs^Fms, Gs^Fds, Rp, Gs^Fds, Gs^Fds, Gs^Fds, Gll^Fp, Gs^Fds, Gs^Fms, Gs^Fms, Gll^Fp, Gll^Fp, Gll^Fp, Gll^Fp
Gll^Fp, Gll^Fp, Gll^Fp, Gll^Fp, Gll^Fp, Gs^Fms, Gll^Fp, Gs^Fms, Gs^Fds, Gs^Fds, Gs^Fds, Rp, Gs^Fds, Gs^Fds, Gll^Fp, Gs^Fms, Gs^Fms, Gll^Fp, Gs^Fms, Gll^Fp, Gll^Fp, Gll^Fp
Gll^Fp, Gll^Fp, Gs^Fms, Gs^Fms, Gll^Fp, Gs^Fms, Gll^Fp, Gs^Fds, Gs^Fds, Gg^Vhc, Ch, Rp, Kh, Gs^Fds, Gll^Fp, Gs^Fms, Gs^Fms, Gs^Fms, Gll^Fp, Gll^Fp, Gll^Fp, Gll^Fp
Gll^Fp, Gll^Fp, Gll^Fp, Gs^Fms, Gll^Fp, Gll^Fp, Gs^Fms, Gs^Fds, Gs^Fds, Ch, 1 Kh, Ch, Ch, Gg^Vhc, Gs^Fds, Gs^Fds, Gs^Fms, Gs^Fms, Gll^Fp, Gll^Fp, Gll^Fp, Gll^Fp
Gll^Fp, Gll^Fp, Gll^Fp, Gll^Fp, Gll^Fp, Gs^Fms, Gs^Fds, Gg^Vc, Gs^Fds, Ch, Rp, Gs^Fds, Gg, Gs^Fds, Gll^Fp, Gll^Fp, Gll^Fp, Gs^Fms, Gll^Fp, Gll^Fp, Gll^Fp, Gll^Fp
Gs^Fms, Gll^Fp, Gs^Fms, Gll^Fp, Gs^Fms, Gs^Fms, Gs^Fms, Gs^Fds, Gs^Fds, Gs^Fds, Rp, Gs^Fds, Gg, Gs^Fds, Gll^Fp, Gll^Fp, Gll^Fp, Gll^Fp, Gll^Fp, Gg^Vc, Gll^Fp, Gll^Fp
Gs^Fms, Gs^Fms, Gs^Fms, Gs^Fms, Gll^Fp, Gll^Fp, Gs^Fms, Gs^Fds, Gs^Fds, Gs^Fds, Gs^Fds, Rp, Gg^Es, Gs^Fds, Gs^Fds, Gs^Fds, Gs^Fms, Gs^Fms, Gll^Fp, Gll^Fp, Gll^Fp, Gll^Fp
Gs^Fds, Gs^Fms, Gll^Fp, Gs^Fms, Gll^Fp, Gll^Fp, Gll^Fp, Gs^Fds, Gs^Fds, Gs^Fds, Rp, Rp, Gg^Efm, Gs^Fds, Gll^Fp, Gll^Fp, Gs^Fms, Gll^Fp, Gs^Fms, Gll^Fp, Gll^Fp, Gll^Fp
Gs^Fds, Gs^Fds, Gll^Fp, Gll^Fp, Gs^Fds, Gs^Fms, Gs^Fds, Gs^Fds, Gs^Fds, Rp, Gs^Fds, Gg^Fet, Gg^Efm, Gs^Fds, Gll^Fp, Gs^Fds, Gs^Fds, Gs^Fms, Gs^Fms, Gs^Fms, Gs^Fms, Gll^Fp
Gs^Fds, Gs^Fds, Gs^Fds, Gs^Fds, Gs^Fds, Gs^Fds, Gs^Fds, Gll^Fp, Gs^Fds, Rp, Ww, Gs^Fds, Gg, Gs^Fds, Gs^Fds, Gs^Fds, Gs^Fds, Gll^Fp, Gs^Fms, Gll^Fp, Gll^Fp, Gll^Fp
Ww, Gs^Fds, Gs^Fds, Ww, Ww, Gs^Fds, Gg^Vc, Gs^Fds, Ww, Ww^Bw|, Ww, Gg^Vc, Gs^Fds, Gs^Fds, Ww, Gs^Fds, Gs^Fds, Gs^Fds, Gs^Fms, Gll^Fp, Gll^Fp, Gll^Fp
Ww, Ww, Ww, Ww, Ww, Ww, Ww, Ww, Ww, Ww^Bw|, Wo, Ww, Ww, Ww, Gg, Ww, Gs^Fds, Gs^Fds, Gs^Fds, Gll^Fp, Gs^Fds, Gs^Fds
Ds, Ds, Ds, Ds, Ww, Wo, Wo, Wo, Ww, Ww^Bw|, Ww, Wo, Wo, Ww, Ww, Gs^Fds, Gs^Fds, Gs^Fds, Gs^Fds, Gs^Fds, Gs^Fds, Gs^Fds
Ww, Ww, Ww, Ww, Wo, Wo, Ww, Wo, Gs^Fds, Re, Gg^Efm, Ww, Wo, Wo, Wo, Ww, Wo, Wo, Gg^Vc, Gs^Fds, Gs^Fds, Gs^Fds
Wo, Wo, Wo, Wo, Wo, Wo, Wo, Gs^Fds, Ww, Re, Gs^Fds, Gg^Vc, Wo, Wo, Wo, Wo, Wo, Ww, Wwf, Gs^Fds, Ww, Ww
Wo, Wo, Wo, Wo, Wo, Wo, Wo, Wo, Ww, Ww^Bw|, Ww, Ww, Wo, Wo, Wo, Wo, Wo, Wo, Wo, Wwf, Wo, Wo
Wo, Wo, Ww, Wo, Ww, Wo, Wo, Wo, Ww, Ww^Bw|, Ww, Ww, Wo, Wo, Wo, Wo, Wo, Wo, Ww, Ww, Wo, Wo
Wo, Wo, Gs^Fds, Gs^Fds, Gs^Fds, Ww, Gs^Fds, Ww, Ww, Ww^Bw|, Ww, Wo, Ww, Wo, Ww, Ww, Ww, Wo, Wwf, Wo, Wo, Wo
Gs^Fds, Gs^Fds, Gs^Fds, Gs^Fds, Gs^Fds, Gs^Fds, Gs^Fds, Gs^Fds, Gs^Fds, Ww^Bw|, Re, Ww, Gs^Fds, Ww, Gs^Fds, Gs^Fds, Gs^Fds, Gs^Fds, Re, Wwf, Ww, Ww
Gs^Fds, Gs^Fds, Gs^Fds, Gs^Fds, Rp, Gg^Vhc, Gs^Fds, Gs^Fds, Rp, Rp, Gs^Fds, Re, Re, Gs^Fds, Gg^Vhc, Gs^Fds, Gs^Fds, Re, Gs^Fds, Gs^Fds, Gs^Fds, Gs^Fds
Gs^Fds, Gs^Fds, Gs^Fds, Gg, Rp, Gs^Fds, Rp, Rp, Gs^Fds, Gs^Fds, Gll^Fp, Gs^Fds, Gs^Fds, Re, Re, Re, Re^Es, Re, Gs^Fds, Gs^Fds, Gs^Fds, Gs^Fds
Gll^Fms, Gll^Fms, Gs^Fds, Gs^Fds, Gg^Efm, Rp, Gs^Fds, Gll^Fms, Gll^Fp, Gll^Fp, Gll^Fp, Gll^Fp, Gll^Fp, Gll^Fms, Gll^Fms, Gs^Fds, Gs, Gs^Fds, Gs^Fds, Gs^Fds, Gs^Fds, Gs^Fds
Gs^Fds, Gll^Fms, Gs^Fds, Gs^Fds, Gll^Fms, Rp, Rp, Gll^Fms, Gll^Fms, Gll^Fp, Gll^Fms, Gll^Fms, Gll^Fms, Gll^Fms, Gs^Fds, Gs^Fds, Gll^Fp, Gs, Gd, Gs^Fds, Gs^Fds, Gs^Fds
Gll^Fms, Gll^Fms, Gll^Fms, Gll^Fms, Gll^Fms, Gs^Fds, Rp, Gll^Fms, Gll^Fms, Gll^Fms, Gs^Fds, Gll^Fms, Gg, Gs^Fds, Gg, Gs^Fds, Gd, Gll^Fp, Ce, Gs^Vhc, Gs^Fds, Gs^Fds
Gll^Fms, Gll^Fms, Gll^Fp, Gll^Fms, Gll^Fms, Gs^Fds, Gs^Fds, Rp, Rp, Gs^Fds, Gg, Gg, Gs^Fds, Gg, Gs^Fds, Gs, Gs^Fds, Ce, 2 Ke, Ce, Gs^Fds, Gs^Fds
Gll^Fms, Gll^Fms, Gll^Fp, Gll^Fp, Gll^Fp, Gll^Fms, Gll^Fms, Gs^Fds, Gs^Fds, Rp, Gs^Fds, Gs^Fds, Gll^Fp, Gll^Fp, Gs^Fds, Gs^Fds, Gs^Fds, Ce, Ce, Gs^Fds, Gs^Fds, Gs^Fds
Gll^Fp, Gll^Fp, Gll^Fp, Gll^Fp, Gll^Fp, Gll^Fms, Gll^Fms, Gll^Fms, Gs^Fds, Gg^Vhc, Gs^Fds, Gs^Fds, Gll^Fp, Gs^Fds, Gs^Fds, Gs^Fds, Gs^Fds, Gs^Fds, Gs^Fds, Gs^Fds, Gs^Fds, Gs^Fds
Gll^Fp, Gll^Fp, Gll^Fp, Gll^Fp, Gs^Fds, Gll^Fp, Gll^Fp, Gll^Fms, Gs^Fds, Rp, Gs^Fds, Gll^Fms, Gs^Fds, Gs^Fds, Gs^Fds, Gs^Fds, Gs^Fds, Gs^Fds, Gs^Fds, Gs^Fds, Gs^Fds, Gs^Fds
