Gs^Fds, Gs^Fds, Gs^Fds, Rb^Gvs, Gs^Fds, Gs^Fds, Rb^Gvs, Rb^Gvs, Rb^Gvs, Rb^Gvs, Gg^Eff, Gg, Gg, Gg, Rr, Gs, Gs, Gg, Hh, Hh, Hh, Hh, Hh, Hh, Gs^Fds, Gs^Fds, Gs^Fds, Hh^Fds, Hh^Fds, Hh, Hh, Hh, Hh, Hh, Hh, Hh, Hh, Ww, Wo, Ww, Gg, Gs, Gs, Gg, Gg^Eff, Gg^Eff, Rb^Gvs, Rb^Gvs, Rb^Gvs, Rb^Gvs, Rb^Gvs, Rb^Gvs, Rb^Gvs, Rb^Gvs, Re, Re, Gg, Gg
Gg, Gg, Gg, Gs^Fds, Gs^Fds, Rb^Gvs, Rb^Gvs, Rb^Gvs, Rb^Gvs, Rb^Gvs, Rb^Gvs, Gg^Eff, Gs^Eff, Gg, Gg, Rr, Gs, Gg, Gg, Hh^Fds, Hh^Fds, Hh, Hh^Fds, Hh^Fds, Gs^Fds, Gs^Fds, Gg, Hh^Fds, Gs^Fds, Hh^Fds, Gg, Hh, Hh, Hh, Hh, Hh, Hh, Ww, Wo, Wo, Gg, Gs, Gg^Eff, Gg^Eff, Rb^Gvs, Rb^Gvs, Rb^Gvs, Rb^Gvs, Rb^Gvs, Rb^Gvs, Rb^Gvs, Rb^Gvs, Rb^Gvs, Rb^Gvs, Re^_mhh, Gs, Gg, Gg
Gg, Gg, Gg, Gs^Vh, Rb^Gvs, Rb^Gvs, Rb^Gvs, Rb^Gvs, Rb^Gvs, Re^Vh, Rb^Gvs, Rb^Gvs, Rb^Gvs, Gs^Eff, Gs^Eff, Rr, Rr, Gs, Hh, Hh^Fds, Hh, Hh, Hh, Gs^Fds, Re^Vct, Gs^Fds, Gg, Gs^Fds, Re^Vct, Re^Vct, Gg, Hh, Hh, Hh^Fds, Hh^Fds, Hh, Hh, Hh, Ww, Wo, Ww, Gs, Gs, Gg^Eff, Gs^Vh, Rb^Gvs, Re, Rb^Gvs, Re, Rb^Gvs, Re, Rb^Gvs, Re, Re, Rb^Gvs, Gs^Wm, Gs^Eff, Gg
Gg, Gg, Rb^Gvs, Rb^Gvs, Rb^Gvs, Rb^Gvs, Rb^Wm, Rb^Gvs, Rb^Gvs, Rb^Gvs, Rb^Gvs, Rb^Gvs, Rb^Gvs, Rb^Gvs, Rb^Gvs, Gg, Rr, Gs, Re^Vct, Re^Vct, Hh, Hh, Re^Edt, Re^Vct, Re^Ecf, Gg^Edt, Re, Gg, Re^Edt, Re^Ecf, Re^Vct, Hh, Ce, Hh^Fds, Ce, Hh^Fds, Ce, Hh, Hh, Wo, Ww, Gg, Gg, Gg, Gg, Re, Gs^Fds, Re, Gs^Fms, Re, Gs^Fds, Re, Rb^Gvs, Rb^Gvs, Rb^Gvs, Rb^Gvs, Rb^Gvs, Gs^Eff
Rb^Gvs, Rb^Gvs, Rb^Gvs, Rb^Gvs, Rb^Gvs, Rb^Gvs, Rb^Gvs, Rb^Gvs, Rb^Gvs, Rb^Gvs, Rb^Gvs, Rb^Gvs, Rb^Gvs, Rb^Gvs, Re^Edt, Gg, Rr, Gs, Re, Re^Ecf, Re, Re^Edt, Re^Vct, Re, Gs, Re, Re^Vct, Re, Gs^Edt, Re^Vct, Re, Re, Ce, Ce, 4 Ke, Ce, Ce, Hh, Wo, Ww, Ww^Ewl, Gg, Gs^Fds, Gg, Gg^Efm, Gs^Fds, Gll^Fp, Gs^Fms, Gs^Fds, Gs^Fds, Gs^Fds, Re, Rb^Gvs, Rb^Gvs, Rb^Gvs, Rb^Gvs, Rb^Gvs, Rb^Gvs
Rb^Gvs, Rb^Gvs, Rb^Gvs, Rb^Gvs, Rb^Gvs, Rb^Gvs, Rb^Gvs, Rb^Gvs, Rb^Gvs, Rb^Gvs, Re^Vct, Re^Vct, Re^Edt, Re, Re^Ecf, Re^Edt, Gs, Rr, Gg^Edt, Gg, Gg, Re^Vct, Gg, Gs, Gg, Re^Vct, Gg, Gg, Gg^Eff, Gs, Gg, Re, Ce, Ce, Ce, Ce, Ce, Gs, Wo, Ww, Gg, Gg, Gs^Fds, Gs^Fds, Gs^Fds, Gs^Fms, Gll^Fp, Gll^Fp, Gs^Fds, Gs^Fds, Gs^Fds, Re, Gs^Vh, Rb^Gvs, Rb^Gvs, Rb^Gvs, Rb^Gvs, Rb^Gvs
Rb^Gvs, Rb^Gvs, Rb^Gvs, Re^Vh, Rb^Gvs, Rb^Gvs, Rb^Gvs, Rb^Gvs, Rb^Gvs, Rb^Gvs, Rb^Gvs, Re^Ecf, Re^Edt, Re, Re^Vct, Re^Vct, Gs, Rr, Gg^Edt, Re^Ecf, Re^Vct, Gg, Gg, Gg, Gg^Eff, Gg, Gg^Eff, Gg^Eff, Rb^Gvs, Gg^Eff, Gg^Eff, Gg, Gg, Gg, Gs, Gs, Gs, Gs, Ww, Ww, Gg, Gg, Re, Gs^Fds, Gs^Fds, Gs^Fms, Gs^Fds, Gs^Fms, Re, Re, Re, Re, Gs^Fms, Gs^Fds, Gs^Fms, Gs^Fds, Gs^Fds, Gs^Fds
Rb^Gvs, Rb^Gvs, Rb^Gvs, Rb^Gvs, Rb^Gvs, Rb^Gvs, Rb^Gvs, Rb^Gvs, Re, Rb^Gvs, Re, Re, Ce, Re, Re, Gg, Gs, Rr, Rr, Re^Vct, Gg, Gg, Gg^Eff, Gg^Eff, Rb^Gvs, Gg^Eff, Rb^Gvs, Rb^Gvs, Rb^Gvs, Rb^Gvs, Rb^Gvs, Gg^Eff, Gg^Eff, Gg, Gg, Gs, Gg, Gs, Gg, Ww, Ww^Bw/, Re, Gs^Fds, Re, Re, Re, Re, Gs^Fds, Re, Gs^Fds, Ww^Bw|, Gs^Fds, Ww, Gs^Fms, Ww, Gs^Fds, Ww, Gs^Fds
Rb^Gvs, Rb^Gvs, Rb^Gvs, Rb^Gvs, Rb^Gvs, Rb^Gvs, Re^Vct, Re^Edt, Re, Re, Ce, 3 Ke, Ce, Ce, Ce, Re, Gg, Gs, Gs, Rr, Rr, Gg^Eff, Gg^Eff, Rb^Gvs, Rb^Gvs, Rb^Gvs, Rb^Gvs, Rb^Gvs, Rb^Gvs, Rb^Gvs, Rb^Gvs, Rb^Gvs, Rb^Gvs, Gg^Eff, Gg^Eff, Gg, Re^Eff, Gg^Eff, Re, Re, Ww, Gs^Fds, Ww, Gs^Fds, Gs^Fds, Gs^Fds, Gs^Fds, Re, Ww, Ww, Re, Ww, Gs^Fds, Ww, Ss, Ww, Ww, Ww
Rb^Gvs, Rb^Gvs, Rb^Wm, Rb^Gvs, Gs^Fds, Re^Vct, Re^Ecf, Re^Edt, Re, Ce, Ce, Ce, Ce, Ce, Gg, Re, Gg, Gg, Gs^Fds, Gg, Gg, Rr, Gg, Gg^Eff, Gg^Eff, Rb^Gvs, Rb^Gvs, Rb^Gvs, Rb^Gvs, Rb^Gvs, Rb^Gvs, Rb^Gvs, Gs^Fds, Gs^Fds, Re, Re^Eff, Rb^Gvs, Re, Gg, Gg, Gg, Wwr, Wo, Ww, Ww, Ww, Ww, Ww, Gg, Gg, Re, Gg^Efm, Gs^Fds, Gs^Fds, Gs^Emf, Ss, Gs^Em, Gs^Fms
Rb^Gvs, Rb^Gvs, Rb^Gvs, Rb^Gvs, Gs^Fds, Gs^Fds, Re^Edt, Gg, Gg, Gg, Gg, Ce, Gg, Gg, Gg, Gg, Gg^Eff, Gg^Eff, Gg^Eff, Gs^Fms, Gs^Fds, Rr, Gg^Eff, Gg^Eff, Re^Vh, Rb^Gvs, Rb^Gvs, Rb^Gvs, Gs^Fds, Rb^Gvs, Gs^Fds, Gs^Fds, Re, Re, Rb^Gvs, Rb^Gvs, Gs^Fds, Gs^Fds, Gs^Fds, Gs^Fds, Ww, Wo, Gs^Qhhf, Gs^Qhhf, Gs^Fms, Gs^Fds, Gs^Fds, Gs^Fds, Gs^Fds, Re, Gs^Fds, Gs^Fds, Gs^Fms, Ss, Gll^Fp, Gs^Em, Ss, Ss
Rb^Gvs, Rb^Gvs, Rb^Gvs, Rb^Gvs, Re, Gg, Re^Vct, Re^Vct, Gg, Gs, Gs, Gg, Gs, Gs, Gg^Eff, Gg^Eff, Rb^Gvs, Rb^Gvs, Rb^Gvs, Gg^Eff, Gg^Eff, Rr, Rr, Gg^Eff, Re, Re, Re, Gs^Fds, Re, Re^Vh, Re, Re, Rb^Gvs, Rb^Gvs, Rb^Gvs, Rb^Gvs, Gs^Fds, Gs^Fms, Gs^Fds, Gg, Gg, Wo, Gs^Qhhf, Gs^Fms, Gll^Fp, Hh^Fms, Hh^Fms, Hh^Fds, Gg^Efm, Re, Re, Gs^Fds, Gs^Fds, Gs^Fms, Gs^Fms, Gll^Em, Gs^Fds, Gs^Fds
Rb^Gvs, Rb^Gvs, Rb^Gvs, Re^Vh, Gg, Re, Re^Edt, Re^Ecf, Gg, Gs, Gs, Gs, Gg^Vh, Gg^Eff, Rb^Gvs, Rb^Gvs, Rb^Gvs, Rb^Gvs, Rb^Gvs, Rb^Gvs, Rb^Gvs, Gg^Eff, Re, Rr, Rr, Gg^Eff, Gg^Eff, Re, Rb^Gvs, Re, Rb^Gvs, Re, Re^Vwm, Rb^Gvs, Rb^Gvs, Rb^Gvs, Rb^Gvs, Rb^Gvs, Gs^Vl, Gg, Gg, Wwr, Wo, Ww, Gs^Qhhf, Hh^Fp, Gll^Qhhf, Hh^Fds, Gs^Qhhf, Gs^Fds, Re, Gs^Fds, Gs^Fds, Gs^Fms, Gs^Fms, Gs^Fms, Gs^Fms, Gs^Fds
Rb^Gvs, Rb^Gvs, Rb^Gvs, Rb^Gvs, Rb^Gvs, Gg, Gg, Re^Edt, Gg, Gs, Gg^Eff, Gg^Eff, Rb^Gvs, Rb^Gvs, Rb^Gvs, Rb^Gvs, Rb^Gvs, Rb^Gvs, Rb^Gvs, Rb^Gvs, Rb^Gvs, Rb^Gvs, Re, Gg^Eff, Gg^Eff, Rr, Gg^Eff, Gg^Eff, Rb^Gvs, Rb^Gvs, Rb^Gvs, Rb^Gvs, Rb^Gvs, Rb^Gvs, Rb^Gvs, Rb^Gvs, Rb^Gvs, Rb^Gvs, Rb^Gvs, Gg, Gg, Gg, Ww^Ewl, Wo, Wwr, Gll^Qhhf, Ww, Gs^Qhhf, Ww, Gs^Fds, Ww^Bw|, Gs^Qhhf, Gs^Qhhf, Gll^Fp, Gll^Fp, Gs^Fms, Gs^Fms, Gs^Fms
Rb^Gvs, Rb^Gvs, Rb^Gvs, Rb^Gvs, Gg^Eff, Gg^Eff, Gg, Re, Re, Gg, Gg, Gg^Eff, Gg^Eff, Rb^Gvs, Rb^Gvs, Rb^Gvs, Rb^Gvs, Rb^Gvs, Rb^Gvs, Rb^Gvs, Rb^Gvs, Rb^Gvs, Re^Eff, Gg^Eff, Gs^Fds, Rr, Rr, Gg^Eff, Gg^Eff, Rb^Gvs, Rb^Gvs, Rb^Gvs, Rb^Gvs, Rb^Gvs, Rb^Gvs, Rb^Gvs, Rb^Gvs, Rb^Gvs, Rb^Gvs, Gs^Fds, Gs^Fds, Gs^Fms, Gg, Gg, Gg, Ww, Gs^Fds, Ww, Gs^Fds, Ww, Re, Ww, Ww, Gll^Qhhf, Gs^Qhhf, Gll^Fp, Gs^Fds, Gs^Fds
Rb^Gvs, Rb^Gvs, Gg^Eff, Gg^Eff, Gg, Gg, Gg, Gs, Re, Re^Vct, Gs, Gs, Gs, Gg^Eff, Gg^Eff, Rb^Gvs, Rb^Gvs, Rb^Gvs, Rb^Gvs, Rb^Gvs, Re^Vh, Re, Rb^Gvs, Gg^Eff, Gg^Eff, Gs^Fds, Gs^Fms, Rr, Rr, Gg^Eff, Gg^Eff, Rb^Gvs, Rb^Gvs, Rb^Gvs, Rb^Gvs, Rb^Gvs, Rb^Gvs, Rb^Gvs, Gg^Eff, Gg^Eff, Re, Gg, Re, Re, Re, Gs^Fds, Re, Gs^Fds, Re, Re, Gg, Gs^Fds, Gs^Fds, Ww, Ww, Ww, Gs^Fds, Gs^Fms
Gg^Eff, Gg^Eff, Gg, Gs, Re^Vct, Re^Vct, Re^Edt, Re, Gg, Gg, Gg^Edt, Gs, Gg, Gs, Gs, Gg^Eff, Re, Re, Re, Re, Rb^Gvs, Rb^Gvs, Rb^Gvs, Rb^Gvs, Rb^Gvs, Gg^Eff, Gg^Eff, Gs^Fds, Rr, Gg^Eff, Gg^Eff, Rb^Gvs, Rb^Gvs, Rb^Gvs, Rb^Gvs, Rb^Gvs, Gg^Eff, Gg, Re, Re, Rb^Gvs, Re, Hh^Fds, Hh^Fds, Hh^Fds, Re, Gs^Fds, Re, Hh, Gs^Fms, Gs^Fms, Gs^Fds, Gs^Fms, Gs^Fds, Ww, Gs^Qhhf, Gs^Qhhf, Gs^Fms
Gg, Gg, Gs, Gs, Gs, Re^Ecf, Re^Edt, Gs, Re^Vct, Gg, Re^Edt, Re^Ecf, Re^Vct, Gg, Gg, Gg, Gg^Wm, Re, Rb^Gvs, Rb^Gvs, Rb^Gvs, Rb^Gvs, Rb^Gvs, Rb^Gvs, Rb^Gvs, Rb^Gvs, Rb^Gvs, Gg^Eff, Re^Eff, Rr, Rr, Gg^Eff, Gg^Eff, Rb^Gvs, Gg^Eff, Gg^Eff, Re, Re^Vh, Rb^Gvs, Rb^Gvs, Rb^Gvs, Rb^Gvs, Rb^Gvs, Gs^Fds, Gs^Fds, Hh^Fds, Hh^Fds, Hh, Hh, Hh^Fds, Gs^Fds, Hh^Fds, Gs^Fds, Gs^Fds, Hh, Ww, Ww, Hh^Qhhf
Gg, Gg^Efm, Gg, Gs, Gs, Gg, Gg, Re^Vct, Re, Re, Gg, Re^Vct, Gg, Gg, Gg^Eff, Gg^Eff, Rb^Gvs, Gs^Fds, Gs^Fds, Rb^Gvs, Rb^Gvs, Rb^Gvs, Rb^Gvs, Rb^Gvs, Rb^Gvs, Rb^Gvs, Re^Eff, Re^Eff, Rb^Gvs, Gs^Fds, Gs^Fms, Rr, Rr, Gg^Eff, Rr, Re, Rr, Gg^Eff, Gg^Eff, Rb^Gvs, Rb^Gvs, Rb^Gvs, Gg^Eff, Gs^Fds, Gs^Fds, Gs^Fds, Gs^Fms, Gs^Fms, Gg, Gs^Fms, Hh^Qhh, Hh^Fds, Hh, Hh^Fds, Hh, Wwr, Ww, Hh^Fds
Gg, Gg, Gg, Gg, Gg, Gg, Gg, Re, Re^Ecf, Gg, Gg, Gg, Gg^Eff, Gg^Eff, Rb^Gvs, Rb^Gvs, Rb^Gvs, Rb^Gvs, Rb^Gvs, Gs^Fds, Gs^Fds, Rb^Gvs, Rb^Gvs, Rb^Gvs, Re^Vwm, Re^Eff, Rb^Gvs, Rb^Gvs, Rb^Gvs, Rb^Gvs, Rb^Gvs, Gs^Fms, Gs^Fds, Rr, Re, Rr, Gg, Rr, Rr, Gg^Eff, Gg^Eff, Gg^Eff, Gg, Gs, Gs, Gg, Gg, Gg, Gg, Gg, Hh^Qhh, Hh^Fds, Hh, Hh, Hh^Fds, Hh, Hh, Ww
Gll^Fp, Gs^Fds, Gs^Fds, Gg, Re^Vct, Re^Vct, Gg^Edt, Gg, Re^Vct, Re^Vct, Gg^Eff, Gg^Eff, Rb^Gvs, Rb^Gvs, Rb^Gvs, Rb^Gvs, Rb^Gvs, Rb^Gvs, Rb^Gvs, Rb^Gvs, Rb^Gvs, Gs^Fds, Re^Eff, Re^Eff, Rb^Gvs, Rb^Gvs, Rb^Gvs, Rb^Gvs, Rb^Gvs, Rb^Gvs, Rb^Gvs, Rb^Gvs, Re, Re, Gs^Fds, Gg, Gs, Gg, Gg, Rr, Rr, Gg, Gg, Gs, Ce, Gg^Edt, Gg^Edt, Gg, Gg, Hh^Qhh, Hh^Fds, Hh^Fds, Hh, Hh^Fds, Hh^Fds, Hh, Hh^Fds, Hh
Gs^Fms, Gs^Fms, Gs^Fms, Gg, Gg, Re^Ecf, Re^Edt, Re, Gg, Gg, Gg^Eff, Gg^Eff, Rb^Gvs, Rb^Gvs, Rb^Gvs, Rb^Gvs, Rb^Gvs, Rb^Gvs, Rb^Gvs, Rb^Gvs, Gs^Fds, Re^Eff, Re^Eff, Rb^Gvs, Rb^Gvs, Rb^Gvs, Rb^Gvs, Rb^Gvs, Rb^Gvs, Rb^Gvs, Re, Re, Rb^Gvs, Gg^Vh, Gg^Eff, Gs^Fds, Gg, Gs, Gg, Gg, Rr, Gg, Ce, Ce, Gg, Gg, Gg, Gg, Hh^Qhh, Hh^Qhh, Hh^Qhh, Hh^Qhh, Hh^Qhh, Hh^Fds, Hh, Hh, Hhd, Hhd
Gll^Fp, Gll^Fp, Gs^Fms, Gs^Fms, Gs, Re^Edt, Ce, Ce, Ce, Gg, Gg^Eff, Gg^Eff, Rb^Gvs, Rb^Gvs, Rb^Gvs, Rb^Gvs, Rb^Gvs, Rb^Gvs, Rb^Gvs, Gs^Fds, Rb^Gvs, Rb^Gvs, Rb^Gvs, Re, Re^Eff, Rb^Gvs, Rb^Gvs, Rb^Gvs, Re, Re, Rb^Gvs, Rb^Gvs, Rb^Gvs, Rb^Gvs, Rb^Gvs, Gg^Eff, Gg^Eff, Gs, Gg, Gg, Ce, Rr, Rr, Gg, Gg, Re^Vct, Re^Ecf, Re^Vct, Re, Re, Re, Re, Hh^Qhh, Hh, Hh, Hhd, Hhd, Hhd
Gll^Fp, Gll^Fp, Gs^Fds, Gs^Fms, Gs, Re, Ce, 2 Ke, Ce, Ce, Gg, Gg^Eff, Gg^Eff, Rb^Gvs, Rb^Gvs, Rb^Gvs, Gs^Fds, Rb^Gvs, Rb^Gvs, Rb^Gvs, Rb^Gvs, Rb^Gvs, Rb^Gvs, Rb^Gvs, Rb^Gvs, Re^Eff, Re^Eff, Re, Rb^Gvs, Rb^Gvs, Rb^Gvs, Rb^Gvs, Rb^Gvs, Rb^Gvs, Gg^Eff, Gg^Eff, Gg, Gg, Ce, Ce, Gg, Gg, Gg, Rr, Re, Re^Vct, Re, Re, Ce, Ce, Ce, Re, Hh^Qhh, Hh, Hh, Hhd, Hhd, Hhd
Gll^Fp, Gs^Em, Gs^Fds, Gs^Fms, Gs, Gs, Gs, Ce, Ce, Gg, Gg, Gg, Gg, Gg^Eff, Gg^Eff, Gs^Fds, Rb^Gvs, Rb^Gvs, Rb^Gvs, Rb^Gvs, Rb^Gvs, Rb^Gvs, Rb^Gvs, Rb^Gvs, Re^Eff, Re^Eff, Gs^Fds, Gg^Eff, Gg^Eff, Rb^Gvs, Rb^Gvs, Rb^Gvs, Gg^Eff, Gg^Eff, Gs^Fds, Gs^Fds, Gg, Gg, Gg, Gg, Re, Gg, Gg, Rr, Rr, Re, Re^Vct, Ce, Ce, Ke, Ce, Re, Hh^Qhh, Hh^Fds, Hhd, Hhd, Hh, Hhd
Gs^Fp, Gs^Fds, Gs^Fds, Gs^Fms, Gs^Fds, Gs, Gs, Gs, Gs, Gg, Gg, Gg^Efm, Gg, Gs^Fds, Gs^Fds, Gg^Eff, Gg^Eff, Rb^Gvs, Rb^Gvs, Rb^Gvs, Rb^Gvs, Rb^Gvs, Gg^Eff, Gs^Vh, Re, Gs^Fds, Gg, Gg, Gg, Gg^Eff, Gg^Eff, Gg^Eff, Gg, Gg^Efm, Gg^Efm, Gs^Fds, Hh^Qhh, Gg, Re, Re^Vct, Re^Ecf, Re^Vct, Re, Re, Re^Vct, Rr, Re^Ecf, Re, Ce, Ce, Gg, Gg, Hh^Qhh, Hh^Qhh, Hh^Qhh, Hh, Hh, Hh
Gll^Fp, Gs^Fds, Gs^Fp, Gs^Fds, Gs^Fms, Gs^Fds, Gs^Fms, Gs^Fms, Gs, Gg, Gg^Efm, Gg^Efm, Gg, Gs^Fds, Gg, Gs^Fds, Gg, Gg^Eff, Gg^Eff, Rb^Gvs, Gg^Eff, Gg^Eff, Gg, Gg, Re, Gg, Re, Gg, Re, Re, Re, Gg, Gs^Fds, Gs^Fds, Gg^Fds, Hh^Fds, Hh^Qhhf, Gg, Gg, Re^Vct, Gg, Re, Ce, Ce, Re, Rr, Rr, Re^Vct, Gs, Gg, Gg, Gg, Gg, Gg, Hh^Qhh, Hh^Qhh, Hh^Qhh, Hh^Qhh
Gll^Fp, Gll^Fp, Gll^Fp, Gll^Fp, Gs^Fms, Gs^Fp, Gg, Gg, Gg, Gg, Hh, Hh, Gg, Gg, Gg^Efm, Gg, Gg^Efm, Gg, Gg, Gg^Eff, Gg, Gg, Gg, Gg, Gg, Re, Hh, Re, Hh, Hh, Re, Gg, Rb^Gvs, Rb^Gvs, Hh, Hh^Fds, Hh, Hh^Qhh, Hh^Qhh, Gg, Gg, Ce, 1 Ke, Ce, Ce, Re^Vct, Gg, Rr, Rr, Gs, Gg, Gg, Gg^Efm, Gg, Gs^Fds, Gs^Fds, Hh^Fds, Hh^Fds
Gs^Fms, Gll^Fp, Gs^Emf, Gs^Fms, Gll^Fp, Gll^Fp, Gs^Fp, Gg^Efm, Gg, Hh, Hh, Hh, Gg, Gg, Gg, Gg^Efm, Gg, Gg, Rb^Gvs, Rb^Gvs, Rb^Gvs, Rb^Gvs, Gg, Gg^Efm, Gg^Efm, Gg, Hh, Hh, Hh, Gg, Re, Rb^Gvs, Rb^Gvs, Rb^Gvs, Rb^Gvs, Hh, Hh, Hh^Qhh, Gg, Gg, Gg, Ce, Ce, Ce, Gg, Gg, Gg^Efm, Gg, Gg, Rr, Gg, Gg^Efm, Gg^Efm, Gs^Fds, Gs^Fds, Hh^Fds, Hh^Fds, Hh
Gs^Fms, Gs^Fms, Gs^Fms, Gs^Em, Gs^Fms, Gll^Fp, Gs^Fp, Gg, Hh, Hh, Gg, Hh, Gg, Gg, Hh, Gg, Gg, Rb^Gvs, Gll^Fp, Rb^Gvs, Rb^Gvs, Rb^Gvs, Gg, Gg^Efm, Gg, Hh, Hh^Fms, Hh, Gll^Fp, Hh, Re, Rb^Gvs, Rb^Gvs, Rb^Gvs, Hh^Fds, Hh, Hh, Hh^Qhh, Hh^Qhh, Gg, Gg, Gg, Gg, Gg, Gg, Gg^Efm, Gg^Efm, Gg, Gg, Rr, Gg, Gg, Gs^Fds, Gs^Fds, Gs^Fms, Gs^Fds, Hh^Fds, Hh^Fds
Gll^Fp, Gs^Fms, Gll^Fp, Gll^Fp, Gll^Fp, Gll^Fp, Gll^Fp, Gll^Fp, Gg^Vl, Gg, Gg, Gg, Gg, Gg, Hh, Gg, Hh, Gll^Fp, Gll^Fp, Rb^Gvs, Gs^Vl, Gg, Hh^Fms, Gg, Gg, Hh, Hh, Gs^Fms, Gll^Fp, Gll^Fp, Re, Rb^Gvs, Gg^Fds, Hh^Fds, Gg^Fds, Hh, Gg, Hh^Qhh, Gg, Gg, Gg, Gg, Gg^Efm, Gg, Gg, Gg, Gg, Gg, Gs, Rr, Rr, Gg, Gg, Gs^Fds, Gs^Fms, Gs^Fds, Gll^Fp, Gs^Fds
Gs^Em, Gs^Fms, Gs^Fms, Gs^Fms, Hh^Fp, Gs^Fp, Hh, Gs^Fp, Re, Gg, Ww^Es, Ww^Es, Hh, Hh, Hh, Hh, Gs^Fp, Gll^Fp, Gll^Fp, Gs^Fms, Gs^Fms, Hh^Fms, Gll^Fp, Gll^Fp, Gll^Fp, Gs^Fms, Gs^Fms, Gs^Fms, Gll^Fp, Gg^Vl, Gg, Gg, Gs^Fds, Gg^Fds, Gg, Gg, Gg, Gg, Hh^Qhh, Hh^Qhh, Gg, Gg, Gg, Gg, Rb^Gvs, Gs^Vl, Rb^Gvs, Gg, Gg, Gs, Gs, Rr, Gg, Gs^Fds, Gs^Fds, Gs^Fms, Gll^Fp, Gs^Fds
Gll^Fp, Gll^Fp, Gll^Fp, Hh^Fp, Hh, Hh, Hh, Gg, Gg, Ww^Bw\, Ww, Ww^Es, Hh, Hh, Hh, Hh^Fp, Hh^Fp, Gs^Fp, Gs^Fms, Gs^Fms, Hh^Fms, Hh^Fms, Gll^Fp, Gll^Fp, Gs^Fp, Gs^Fms, Gs^Fms, Gs^Fms, Gs^Fp, Gll^Fp, Gll^Fp, Gll^Fp, Hh^Fms, Gs^Fms, Gs^Fms, Hh^Qhh, Hh^Qhh, Gg, Hh^Qhh, Hh^Qhh, Hh^Qhh, Gg, Rb^Gvs, Rb^Gvs, Rb^Gvs, Rb^Gvs, Rb^Gvs, Rb^Gvs, Rb^Gvs, Gs, Gs, Rr, Rr, Gg, Gg, Gs^Fms, Gs^Fms, Gs^Fms
Hh^_mh, Gs^Fp, Hh^Fp, Hh^Fp, Hh, Hh, Hh^Fp, Hh, Ww, Ww, Wo, Ww, Wwr, Hh, Hh, Hh, Hh, Hh^Fp, Hh, Hh, Hhd, Hh, Gll^Fp, Gll^Fp, Gll^Fp, Gs^Fms, Gll^Fp, Gs^Fms, Gs^Fms, Gll^Fp, Gll^Fp, Hh, Hh, Gs^Fms, Hh, Hh, Hh, Hh^Qhh, Hh, Hh^Qhh, Hh^Qhh, Gg, Hh^Qhh, Rb^Gvs, Hh^Qhh, Rb^Gvs, Rb^Gvs, Rb^Gvs, Rb^Gvs, Gg, Gg^Efm, Gg, Gg, Rr, Gg, Gs^Fds, Gg, Gs^Fms
Gg, Hh, Hh, Hh, Hh, Hh^Fp, Gg^Fp, Wwr, Ww, Wo, Wo, Wo, Ww, Hh, Gg, Hh, Hh, Hhd, Hhd, Hhd, Hhd, Gs^Fp, Gll^Fp, Gll^Fp, Gg, Gll^Fp, Hh, Gll^Fp, Gll^Fp, Gll^Fp, Hh, Hh, Hh, Hh, Hh, Hh, Hh, Hh, Hh, Hh, Hh, Hh^Qhh, Hh^Qhh, Hh^Qhh, Gg^Qhh, Rb^Gvs, Rb^Gvs, Rb^Gvs, Gg, Gg, Gg^Efm, Gg^Efm, Re, Rr, Gg, Gg, Gg, Gg
