Hh^Qhh, Hh^Qhh, Hh^Qhh, Gs, Gs, Hhd^Qhux, Hhd^Qhux, Hhd^Qhux, Hhd^Qhux, Hhd^Qhux, Hhd^Qhux, Hhd^Qhux, Gs, Gs, Gs, Gs, Gs, Gg, Gs, Ww^Qhu, Gg, Gg, Gg, Gg, Gg, Gs^Fds, Gs^Fds, Gs^Fds, Gll^Fp, Gll^Fp, Gs^Fms, Gs^Fms, Gs^Fms, Gs^Fms, Gs^Fms, Gs^Fms, Gs^Fms, Gs^Fds, Gs^Fds, Gs^Fds
Hh^Qhh, Hh^Qhh, Hh^Qhh, Hh^Dr, Rd^Es, Hhd^Qhux, Rd, Hhd^Qhux, Hhd^Qhux, Hhd^Qhux, Rd, Rd, Rd, Gs, Rd^Es, Rd^Es, Rd, Gs, Ww^Qhu, Ww^Qhu, Gg, Gg^Efm, Gg^Efm, Gs^Fds, Gs^Fds, Gs^Fms, Gs^Fms, Gll^Fp, Gll^Fp, Gll^Fp, Gs^Fms, Gs^Fds, Gs^Fds, Gs^Fds, Gs^Fds, Gs^Fds, Gll^Fp, Gs^Fds, Gs^Fms, Gs^Fds
Hh^Qhh, Hh^Qhh, Hh^Qhh, Hh^Vhh, Hh^Qhh, Rd^Es, Hh^Qhh, Gs, Gs, Rd, Hh^Qhh, Hh^Qhh, Hh^Qhh, Gs, Hh^Qhh, Hh^Qhh, Ww^Qhu, Rd, Wwf^Qhu, Gg, Gg, Gg^Efm, Gg, Gs^Fds, Gs^Fds, Gs^Fms, Gs^Fms, Gs^Fds, Gs^Fds, Gs^Fms, Gs^Fds, Gs^Fds, Gs^Vl, Gs^Fds, Gs^Fds, Gll^Fp, Gs^Fds, Gs^Fms, Gs^Fds, Gs^Em
Hh^Qhh, Hh^Qhh, Hh^Qhh, Hh^Qhh, Hh^Qhh, Hh^Qhh, Hh^Qhh, Hh^Qhh, Hh^Qhh, Rd^Es, Hh^Dr, Hh^Qhh, Hh^Qhh, Hh^Qhh, Ww^Qhu, Ww^Qhu, Ww^Qhu, Ww^Qhu, Re, Re, Gs^Fds, Gg, Gs^Fms, Gg, Gg, Gg, Gg, Gs^Fds, Gs^Fds, Gs^Fms, Gs^Fds, Gs^Fds, Gs^Fds, Gs^Fds, Gs^Fds, Gs^Em, Gs, Gs^Fms, Gs^Fms, Gs^Fds
Hh^Qhh, Hh^Qhh, Hh^Qhh, Hh^Qhh, Hh^Qhh, Hh^Qhh, Hh^Qhh, Hh^Qhh, Hh^Qhh, Gs^Es, Hh^Vhh, Hh^Qhh, Hh^Qhh, Hh^Qhh, Wo^Qhu, Wo^Qhu, Ww^Qhu, Gg, Re, Gs^Fds, Rb^Gvs, Gs^Fds, Gs^Fms, Gs^Fds, Gs^Fds, Gs^Fds, Gg, Gs^Fds, Gg, Gg, Gg, Gg, Co, Co, Co, Gs, Gs^Fms, Gs, Gs^Fms, Gs^Fds
Ww^Qhu, Hh^Qhh, Hh^Qhh, Ww^Qhu, Ww^Qhu, Hh^Qhh, Hh^Qhh, Hh^Qhh, Hh^Qhh, Hh^Dr, Hh^Qhh, Hh^Qhh, Ww^Qhu, Ww^Qhu, Wo^Qhu, Ww^Qhu, Gg^Eff, Gg^Eff, Re, Rb^Gvs, Rb^Gvs, Rb^Gvs, Rb^Gvs, Gs^Fms, Gs^Fds, Gg, Gs^Fds, Gg, Gg, Gg^Efm, Gg^Efm, Gg, Co, 1 Ko, Co, Gs^Fds, Gs^Fds, Gs^Fms, Gll^Fp, Gs^Fds
Gg, Ww^Qhu, Ww^Qhu, Ww^Qhu, Ww^Qhu, Hh^Qhh, Hh^Qhh, Ww^Qhu, Hh^Qhh, Hh^Qhh, Hh^Qhh, Hh^Qhh, Ww^Qhu, Wo^Qhu, Ww^Qhu, Gg, Rb^Gvs, Rb^Gvs, Rb^Gvs, Re, Gs^Vh, Rb^Gvs, Gs^Fds, Gs^Fds, Gs^Eff, Gs^Eff, Rb^Gvs, Gs^Eff, Gs^Eff, Gg, Gg, Gg, Gg, Co, Gg, Gs^Fds, Gs^Fds, Gs^Fds, Gll^Fp, Gs^Fds
Hh, Hh, Hh, Hh, Ww^Qhu, Ww^Qhu, Ww^Qhu, Ww^Qhu, Ww^Qhu, Hh^Qhh, Hh^Qhh, Hh^Qhh, Ww^Qhu, Wo^Qhu, Gs^Fms, Gg, Rb^Gvs, Rb^Gvs, Rb^Gvs, Re, Rb^Gvs, Rb^Gvs, Gs^Fds, Gs^Fds, Rb^Gvs, Rb^Gvs, Rb^Gvs, Rb^Gvs, Rb^Gvs, Gs^Eff, Gs^Eff, Gs^Eff, Gs^Eff, Gg, Gg, Gg, Gs^Fds, Gs^Fms, Gs^Fms, Gs^Fds
Hh, Hh, Hh, Hh, Gs^Es, Ww^Qhu, Gg, Ww^Qhu, Ww^Qhu, Ww^Qhu, Ww^Qhu, Ww^Qhu, Gs^Fms, Ww^Qhu, Gll^Fp, Gs^Fms, Rb^Gvs, Rb^Gvs, Gs^Fds, Re, Rb^Wm, Rb^Gvs, Rb^Gvs, Rb^Gvs, Rb^Gvs, Gs^Vh, Rb^Gvs, Rb^Gvs, Rb^Gvs, Rb^Gvs, Gs^Fds, Gs^Vh, Rb^Gvs, Gs^Eff, Gs, Gg, Gg, Gg, Gg, Gs^Fms
Hh, Hh, Hh, Hh, Hh, Gs^Es, Gg, Gg, Gg, Hh, Hh, Gs^Fms, Hh^Fp, Gll^Fp, Gll^Fp, Rb^Gvs, Gs^Vh, Rb^Gvs, Rb^Gvs, Re, Re, Rb^Gvs, Rb^Gvs, Rb^Gvs, Rb^Gvs, Rb^Gvs, Rb^Gvs, Rb^Gvs, Re^Eff, Gs^Fds, Gs^Fds, Rb^Gvs, Rb^Gvs, Rb^Gvs, Rb^Gvs, Gs^Eff, Gs^Eff, Gg, Gs^Fds, Gg
Hh, Gd^Es, Gd^Es, Gs^Es, Gs^Es, Gs, Gs^Eff, Gs^Eff, Gs^Eff, Gg, Hh, Hh, Gs, Hh^Fp, Gs^Fds, Rb^Gvs, Rb^Gvs, Rb^Gvs, Rb^Gvs, Rb^Gvs, Re, Rb^Gvs, Rb^Gvs, Rb^Gvs, Rb^Gvs, Rb^Gvs, Re^Eff, Re^Eff, Rb^Gvs, Rb^Gvs, Rb^Gvs, Rb^Gvs, Rb^Gvs, Rb^Gvs, Rb^Gvs, Rb^Gvs, Gs^Fds, Gs, Gs^Fds, Gs^Fds
Hh, Hh, Gd^Es, Gd, Gs^Eff, Gs^Eff, Rb^Gvs, Rb^Gvs, Rb^Gvs, Gs^Eff, Gs^Eff, Gs, Gs^Eff, Gs^Eff, Gs^Eff, Rb^Gvs, Rb^Gvs, Rb^Gvs, Rb^Gvs, Re, Ch, Ch, Ch, Rb^Gvs, Rb^Gvs, Rb^Gvs, Rb^Gvs, Rb^Gvs, Rb^Gvs, Rb^Gvs, Rb^Gvs, Rb^Gvs, Rb^Gvs, Rb^Gvs, Gs^Fds, Gs^Fds, Gs^Fds, Gs, Gs^Fds, Gs^Fds
Hh, Gd^Es, Gs^Eff, Gs^Eff, Rb^Gvs, Rb^Gvs, Rb^Gvs, Rb^Gvs, Rb^Gvs, Rb^Gvs, Rb^Gvs, Gs, Rb^Gvs, Rb^Gvs, Rb^Gvs, Gs^Eff, Rb^Gvs, Rb^Gvs, Ch, Re, Re^Edt, Re^Vc, Re, Re, Kh, Rb^Gvs, Rb^Gvs, Rb^Gvs, Rb^Gvs, Rb^Gvs, Gs^Vh, Rb^Gvs, Rb^Gvs, Rb^Gvs, Rb^Gvs, Rb^Wm, Rb^Gvs, Gs^Eff, Gs^Eff, Gs^Fds
Hh, Hh, Gd^Es, Gs^Eff, Gs^Eff, Rb^Gvs, Rb^Gvs, Re^Vh, Rb^Gvs, Rb^Gvs, Rb^Gvs, Rb^Gvs, Rb^Gvs, Rb^Gvs, Rb^Gvs, Rb^Gvs, Ch, Ch, Re^Edt, Rr, Rr, Rp, Rp, Ch, Ch, Ch, Ch, Rb^Gvs, Rb^Gvs, Rb^Gvs, Rb^Gvs, Rb^Gvs, Rb^Gvs, Rb^Gvs, Rb^Gvs, Rb^Gvs, Rb^Gvs, Rb^Gvs, Gs^Eff, Gs^Eff
Hh, Hh, Hh, Hh, Gs, Gs^Eff, Re, Rb^Gvs, Rb^Gvs, Rb^Gvs, Rb^Gvs, Rb^Gvs, Re^Vh, Rb^Gvs, Rb^Gvs, Rb^Gvs, Ch, Ch, Re^Vwm, Rp^Vh, Rr, Rr, Rr, Rp, Rr, Rr^Vhc, Ch, Gs^Fds, Gs^Fds, Rb^Gvs, Gs^Fms, Rb^Gvs, Rb^Gvs, Rb^Gvs, Rb^Gvs, Rb^Gvs, Gs^Eff, Gs^Vh, Gg, Gg
Re, Hh, Re, Gs, Re, Re, Gg, Gg^Eff, Gg^Eff, Rb^Gvs, Rb^Gvs, Rb^Gvs, Rb^Gvs, Rb^Gvs, Rb^Gvs, Rb^Gvs, Ch, Re^Edt, Rp^Vh, Rp, Ch, Ch, Ch, Rp, Rr^Vhc, Rr, Rr, Rp, Gs^Fds, Gs^Fms, Gs^Fds, Gs^Fms, Gs^Fds, Rb^Gvs, Gs^Eff, Gs^Eff, Gg, Gg, Gg^Efm, Gg
Rb, Re, Re, Re, Co, Gg, Gg, Gs^Fms, Gs^Fms, Gs^Fds, Gs^Fds, Rb^Gvs, Rb^Gvs, Rb^Wm, Rb^Gvs, Rb^Gvs, Re, Rp^Edt, Rp, Rp^Edt, Ch, 4 Kh, Ch, Rr, Rr, Rr, Ch, Rp, Rp, Rp, Rr, Rr, Rr, Gs, Rr, Gg, Gg, Gg^Efm, Gg, Gg
Rb, Rb, Rb^Vct, Co, 3 Ko, Co, Re^Edb, Gs^Fds, Rb^Gvs, Gs^Fds, Rb^Gvs, Rb^Gvs, Rb^Gvs, Rb^Gvs, Rb^Gvs, Rb^Gvs, Ch, Rp, Rp, Rr, Rr, Ch, Rr, Rr, Rr^Vhc, Rr, Ch, Gs^Fms, Gs^Fms, Gs^Fms, Rb^Gvs, Rb^Gvs, Rb^Gvs, Rr, Gs^Fds, Rr, Rr, Rr, Rr, Rr
Re, Re^Vct, Rb^Edb, Co, Co, Co, Rb^Ecf, Re^Edb, Rb^Gvs, Rb^Gvs, Gd^Vh, Rb^Gvs, Rb^Gvs, Rb^Gvs, Rb^Gvs, Rb^Gvs, Ch, Ch, Rp, Rp^Vhc, Rr, Rr, Re^Edt, Rp, Rr, Rr, Kh, Gll^Fp, Gs^Fms, Rb^Gvs, Rb^Gvs, Rb^Gvs, Rb^Gvs, Gs^Fds, Gs^Fms, Gs^Fms, Gg^Eff, Gg, Gg, Gg
Gg, Re^Edb, Re^Vct, Rb^Ecf, Re, Co, Re^Edb, Re^Edb, Rb^Gvs, Rb^Gvs, Rb^Gvs, Rb^Gvs, Rb^Gvs, Rb^Gvs, Rb^Gvs, Rb^Gvs, Rb^Gvs, Ch, Rr, Rp, Rr, Rr^Vh, Re^Edt, Rp^Vh, Ch, Ch, Gs^Fds, Gll^Fp, Gs^Fds, Rb^Gvs, Rb^Gvs, Gs^Vc, Rb^Gvs, Rb^Gvs, Rb^Gvs, Rb^Gvs, Rb^Gvs, Gg^Eff, Gg^Eff, Gg
Gg, Re, Re, Re^Vct, Re, Re^Edb, Gg, Gs^Fds, Gs^Fds, Rb^Gvs, Rb^Gvs, Rb^Gvs, Rb^Gvs, Gs^Fds, Gs^Fms, Rb^Gvs, Gs, Rp, Gs, Ch, Ch, Re, Ch, Ch, Gs, Gs, Rb^Gvs, Gs^Fms, Rb^Eff, Rb^Gvs, Rb^Gvs, Rb^Gvs, Rb^Gvs, Rb^Gvs, Rb^Gvs, Rb^Gvs, Rb^Gvs, Rb^Gvs, Gg^Eff, Gg^Eff
Gg, Gg, Re^Gvs, Re^Gvs, Re, Re, Gg, Gs^Fds, Gs^Eff, Gs^Eff, Rb^Gvs, Rb^Gvs, Rb^Gvs, Gs^Fds, Gs^Fms, Gs^Fms, Rr, Rp, Gs, Gs, Gs^Fds, Kh, Gs, Gs, Rb^Gvs, Rb^Gvs, Rb^Gvs, Rb^Gvs, Rb^Gvs, Rb^Eff, Re, Re^Wm, Rb^Gvs, Rb^Gvs, Rb^Gvs, Rb^Gvs, Rb^Gvs, Rb^Gvs, Gg^Eff, Gg^Eff
Gg, Re, Re^Gvs, Re^Gvs, Re^Gvs, Gg, Gs^Eff, Gg, Rb^Gvs, Rb^Gvs, Rb^Gvs, Rb^Gvs, Gs^Eff, Gs^Eff, Gg, Rr, Gd^Edt, Gs, Gs^Fds, Gs^Fms, Gll^Fp, Gs^Fms, Gs^Fms, Rb^Gvs, Rb^Gvs, Rb^Gvs, Rb^Gvs, Rb^Gvs, Gs^Vh, Rb^Gvs, Rb^Gvs, Rb^Gvs, Rb^Gvs, Rb^Gvs, Rb^Gvs, Rb^Gvs, Gs^Vh, Gg^Eff, Gg, Gg
Gg, Gg, Gg, Re^Gvs, Gs^Eff, Gs^Eff, Rb^Gvs, Rb^Gvs, Rb^Gvs, Rb^Gvs, Gd^Vh, Gd^Eff, Gd^Edt, Gs, Rr, Rr, Gd^Edt, Gd^Edt, Rb^Gvs, Rb^Gvs, Rb^Gvs, Gs^Fds, Rb^Gvs, Rb^Gvs, Rb^Gvs, Rb^Gvs, Rb^Gvs, Rb^Gvs, Rb^Gvs, Rb^Gvs, Gs^Fds, Gs^Fds, Gs^Eff, Rb^Gvs, Gs^Eff, Gs^Eff, Gs, Gs, Gg, Gg
Gg, Gg^Efm, Gg, Gg, Gg, Gs^Eff, Gs^Eff, Rb^Gvs, Gs^Eff, Gs^Eff, Re, Gd^Edt, Gs, Rp, Gg, Gg, Gs^Eff, Gd^Vh, Rb^Gvs, Rb^Gvs, Rb^Gvs, Gs^Fds, Rb^Gvs, Rb^Gvs, Rb^Gvs, Rb^Gvs, Rb^Gvs, Rb^Gvs, Rb^Gvs, Rb^Gvs, Gg^Eff, Gs^Fds, Gs^Fds, Gg^Eff, Gg, Gs, Gg, Ww, Gg, Gg
Gg, Gg, Gg, Re^Gvs, Re^Gvs, Re, Re^Gvs, Gs^Eff, Gg, Re, Gg, Gs, Rr, Rp, Gg, Gg^Eff, Gg^Eff, Rb^Gvs, Rb^Gvs, Rb^Gvs, Rb^Gvs, Rb^Gvs, Rb^Gvs, Rb^Gvs, Gs^Vh, Rb^Gvs, Rb^Gvs, Rb^Gvs, Gg^Edb, Gg^Eff, Gg^Edb, Gg, Gg, Gg, Gs^Fds, Ww, Ww, Ww, Gs^Fds, Gs^Fds
Gg, Gg^Efm, Gg, Re^Gvs, Re^Gvs, Re^Gvs, Re^Gvs, Gg, Gg^Efm, Gg^Efm, Gg, Rr, Gg, Gg, Gg^Efm, Gg^Efm, Gg, Gg^Eff, Gg^Eff, Rb^Gvs, Gg^Eff, Rb^Gvs, Gs^Eff, Rb^Gvs, Gs^Eff, Gs^Eff, Gg^Eff, Gg^Eff, Gg^Edb, Re^Edb, Re^Edt, Re, Re, Gg, Gs^Fds, Gs^Fds, Ww, Ww^Ewf, Gs^Fds, Gs^Fds
Gg, Gg^Efm, Gg^Efm, Gg, Gg, Gg, Gg, Gg, Gg, Gg^Efm, Rr, Rr, Gg, Gs, Gs, Gg, Gd, Gg, Gd, Gs^Eff, Gs, Gs^Eff, Hh^Qhh, Gs^Eff, Hh^Qhh, Gs, Gs, Gg^Edb, Re^Edt, Re^Edt, Co, Co, Co, Gg, Gs^Fds, Gs^Fds, Gs^Fds, Gs^Fds, Gs^Fds, Gll^Fp
Gd, Gg, Gg, Gg, Gg, Gg, Gg, Gg^Efm, Gg, Gg, Rp, Gg, Gd, Gs, Gs, Gd, Hh^Qhh, Gd, Gs^Fds, Gs^Fds, Hh^Qhh, Hh^Qhh, Hh^Qhh, Hh^Qhh, Hh^Qhh, Hh^Qhh, Gg, Gg, Re, Co, Co, 2 Ko, Co, Gs^Fds, Gs^Fds, Gll^Fp, Gll^Fp, Gll^Fp, Gll^Fp, Gll^Fp
Gd, Gd, Rd, Gd, Rd, Gd, Gs, Gg, Gs^Vc, Rp, Gs^Fds, Gd, Gd, Hh^Qhh, Hh^Qhh, Hh^Qhh, Hh^Qhh, Hh^Qhh, Gs^Fms, Gs^Fms, Gs^Fds, Hh^Qhhf, Hh^Qhh, Hh^Qhh, Hh^Qhhf, Gs^Fms, Gg, Gs^Fms, Gs^Fds, Re^Vct, Rb^Vct, Co, Rb^Edt, Rb, Gs^Fds, Gs^Fds, Gs^Fds, Gs^Fds, Gll^Fp, Gll^Fp
Hh^Qhh, Hh^Qhh, Hh^Qhh, Rd, Hh^Qhh, Gd, Gd, Gs, Rp, Rp, Gs^Fms, Gs^Fms, Gs^Fms, Gs^Fms, Gs^Qhhf, Hh^Qhh, Hh^Qhh, Hh^Qhhf, Hh^Qhh, Hh^Qhhf, Hh^Qhh, Hh^Qhhf, Hhd^Qhh, Hh^Qhh, Hh^Qhh, Gs^Fms, Gll^Fp, Gs^Fms, Gll^Fp, Re^Edt, Re^Edt, Rb^Ecf, Re^Vct, Re^Vct, Re, Gg, Gg, Gs^Fds, Gg, Gll^Fp
Hhd^Qhh, Hh^Qhh, Hhd^Qhh, Hh^Qhh, Hh^Qhh, Hh^Qhh, Hh^Qhh, Rp, Hh^Qhh, Hh^Qhh, Hh^Qhhf, Hh^Qhhf, Hh^Qhhf, Gll^Fp, Hh^Qhhf, Hh^Qhh, Hhd^Qhh, Hh^Qhh, Hhd^Qhh, Hh^Qhh, Hhd^Qhh, Hh^Qhh, Hhd^Qhh, Hh^Qhh, Hh^Qhhf, Hh^Qhhf, Hh^Qhhf, Hh^Qhhf, Hh^Qhhf, Gg, Gg^Edt, Re^Edt, Gg^Edt, Re^Edt, Gg, Gg, Gg, Gg, Gg, Gg
Hhd^Qhh, Hhd^Qhh, Hhd^Qhh, Hhd^Qhh, Hh^Qhh, Hh^Qhh, Rp, Rp, Hh^Qhh, Hh^Qhh, Gg^Qhh, Hh^Qhh, Hh^Qhh, Hh^Qhh, Hhd^Qhh, Hhd^Qhh, Hhd^Qhh, Hhd^Qhh, Hhd^Qhh, Hhd^Qhh, Hhd^Qhh, Hhd^Qhh, Hhd^Qhh, Hhd^Qhh, Hhd^Qhh, Hh^Qhhf, Hh^Qhhf, Hh^Qhhf, Hh^Qhh, Gg, Gg, Gg^Edt, Gg, Re, Re, Gg, Gg, Gg, Gg, Gg
