Gs, Gg, Hh, Hh, Hh, Hh, Hh, Hh, Hh, Hh, Hh, Hh, Hh^Fds, Hh, Hh^Fds, Hh, Hh, Hh, Hh, Hh, Hh, Hh, Hh, Hh, Hh^Fds, Gg, Gll^Fds, Gll^Fds, Gll^Fds, Gg^Fds, Hh^Fds, Hh, Hh, Hh, Hh, Hh, Hh, Hh, Hh, Hh, Hh, Gg, Gg, Gg, Gg, Gg, Gg, Gg, Gg, Gg^Edt, Rr, Gg, Gg, Re^Edt, Gg, Gs^Fds, Gs^Fms, Gll^Fms, Gs^Fds, Gs^Fds, Gs^Fds, Gs^Fds
Gs, Hh, Gs, Hh, Gs, Hh, Hh, Hh, Hh, Hh, Hh, Gg, Gg, Gll^Fds, Gll^Fds, Hh^Fds, Gs, Hh, Hh, Hh, Hh, Gll^Fds, Hh, Hh^Fds, Hh, Hh^Fds, Gll^Fds, Gll^Fds, Gll^Fds, Hh^Fds, Gs, Hh, Hh, Hh, Gg, Hh, Gg, Hh, Gg, Hh, Gg, Gg, Gg, Gg, Gg, Gg, Re^Vct, Gg, Gs, Gg, Rr, Gg, Re^Vct, Gg, Gg^Fms, Gs^Fds, Gll^Fms, Gs^Fds, Gs^Fds, Gs^Fds, Gs^Fds, Gs^Fds
Gs, Gs, Gs, Gs, Gs, Gs, Gs, Gg, Gg, Hh, Gg, Hh, Gg, Gg, Gg, Hh, Gg, Gs, Gs, Hh, Gs, Gs, Hh, Hh, Hh, Hh, Hh, Gs^Fms, Gs, Hh, Hh, Gs, Gs, Gg, Gg, Gg, Gs^Fds, Gg, Gs^Fds, Gg, Gs^Fds, Gg, Gg, Gg, Re, Re^Vct, Re^Ecf, Re, Re^Vct, Gg, Rr, Re, Gs, Gs, Gs^Fms, Gs^Fds, Gg, Gg, Gs^Fds, Gs^Fds, Gs^Fds, Gs^Fds
Gs^Fds, Hh, Gs^Fds, Hh, Gg, Gg, Gs^Fds, Gg, Gg, Gg, Gg, Gg, Gg, Gg, Gs, Gg, Gg, Gg, Gll^Fds, Gs, Hh^Fds, Gs, Hh, Hh, Hh, Hh, Gs, Hh, Hh, Hh, Re, Gs, Re, Gs, Gg, Gg, Gg, Gs^Fms, Gs^Fms, Gs^Fds, Gg, Gs^Fds, Gg, Re^Vct, Re^Vct, Re, Re, Re^Vct, Rr, Rr, Ce, Ce, 2 Ke, Gs, Gg, Gg, Gg, Gs^Vl, Gs^Fds, Gs^Fds, Gs^Fds, Gs^Fds
Hh^Fds, Gs^Fds, Gll^Fds, Hh, Gg, Gs^Fds, Gll^Fds, Hh^Fds, Hh, Hh, Gg, Gg, Gs, Gs, Gs, Gs, Gg, Gg, Hh, Hh^Fds, Hh, Hh, Hh, Hh, Hh, Gs, Gs, Hh, Re, Re, Rb^Gvs, Re, Re^Vhr, Re, Gg, Gg, Gg, Gs^Fms, Gg, Gs^Vl, Gg, Gg, Gg, Gs, Gs, Re^Vct, Rr, Rr, Re, Ce, Re^Ecf, Ce, Ce, Ce, Re, Gg, Gs^Fds, Gg^Fds, Gg^Fms, Gs^Fds, Gs^Fds, Gs^Fds
Gg, Gg, Gg, Gg, Hh, Hh^Fds, Hh^Fds, Hh^Fds, Hh, Gg, Gg, Gs, Gg, Gs, Gg, Gg, Re^Eff, Re, Re, Re, Re, Re, Re, Re, Re, Re, Re, Re, Rb^Gvs, Rb^Gvs, Rb^Gvs, Rb^Gvs, Rb^Gvs, Re, Re, Gg, Gg, Gg, Gg, Gg, Gg, Gg, Gg, Gg, Rr, Rr, Re, Re^Vct, Re^Vct, Re, Re, Ce, Gg, Gg, Re^Vct, Re^Vct, Gs^Fds, Gs^Fds, Gs^Fds, Gg^Fms, Rb^Gvs, Gs^Fds
Re, Re, Re, Re, Re, Gs, Gs, Hh, Gs, Hh, Gg, Gg, Gs, Gs, Re^Eff, Re^Eff, Rb^Gvs, Rb^Gvs, Rb^Gvs, Rb^Gvs, Rb^Gvs, Rb^Gvs, Ch^Qhux, Re, Rb^Gvs, Rb^Gvs, Rb^Gvs, Rb^Gvs, Rb^Gvs, Rb^Gvs, Rb^Gvs, Rb^Gvs, Rb^Gvs, Rb^Gvs, Ch^Qhux, Re, Re, Gg, Gg, Gg, Gg, Gg, Rr, Rr, Gs^Eff, Gs^Eff, Gs^Eff, Gg, Gg, Gs, Gg, Re, Re, Gg, Gg, Gg, Gs^Eff, Gll^Fms, Rb^Gvs, Rb^Gvs, Rb^Gvs, Rb^Gvs
Gg, Gg, Hh, Gg, Gg, Re, Re, Gs, Re, Hh, Hh, Gs, Re^Eff, Re^Vhr, Rb^Gvs, Rb^Gvs, Rb^Gvs, Rb^Gvs, Rb^Gvs, Rb^Gvs, Ch^Qhux, Ch^Qhux, Rr, Ch^Qhux, Ch^Qhux, Rb^Gvs, Rb^Gvs, Rb^Gvs, Rb^Gvs, Rb^Gvs, Rb^Gvs, Rb^Gvs, Ch^Qhux, Ch^Qhux, Rr, Ch^Qhux, Xos, Re, Re, Gg, Rr, Rr, Gs^Eff, Gs^Eff, Rb^Gvs, Rb^Gvs, Rb^Gvs, Gs^Eff, Gs^Eff, Gs^Eff, Gs^Eff, Gg, Gg, Re, Re, Gs^Eff, Rb^Gvs, Rb^Gvs, Rb^Gvs, Rb^Gvs, Rb^Gvs, Rb^Gvs
Hh, Hh, Hh^Fds, Gs, Hh, Gg, Gg, Re, Gg, Re, Re, Re^Eff, Rb^Gvs, Rb^Gvs, Rb^Gvs, Rb^Gvs, Rb^Gvs, Rb^Gvs, Ch^Qhux, Ch^Qhux, Rr, Rr, Rr, Rp, Rr, Ch^Qhux, Ch^Qhux, Rb^Gvs, Rb^Gvs, Rb^Gvs, Ch^Qhux, Ch^Qhux, Rr, Rp, Rr^VjD, Rp, Rp, Rr^Pr\, Rr^Pr\, Rr, Gs, Gs^Eff, Rb^Gvs, Rb^Gvs, Rb^Gvs, Rb^Gvs, Rb^Gvs, Rb^Gvs, Rb^Gvs, Rb^Gvs, Rb^Gvs, Gs^Eff, Gs^Eff, Gs^Eff, Rb^Gvs, Re, Re, Rb^Gvs, Rb^Gvs, Rb^Gvs, Rb^Gvs, Rb^Gvs
Hh, Hh^Fds, Hh^Fds, Hh, Hh, Gs, Gs, Gg, Gg^Eff, Gg^Eff, Re, Re, Rb^Gvs, Rb^Gvs, Rb^Gvs, Rb^Gvs, Ch^Qhux, Ch^Qhux, Rr, Rr, Ch, Rr^Vhc, Ch, Rr, Rr, Rp, Rr, Ch^Qhux, Ch^Qhux, Ch^Qhux, Rr^Edb, Rr, Rr^VjD, Rr^VjE, Rr^Dr, Rr^Vhc, Isa, Isa, Rr, Rr^Pr\, Xos, Rb^Gvs, Rb^Gvs, Rb^Gvs, Rb^Gvs, Rb^Gvs, Rb^Gvs, Rb^Gvs, Rb^Gvs, Rb^Gvs, Rb^Gvs, Rb^Gvs, Rb^Gvs, Rb^Gvs, Rb^Gvs, Rb^Gvs, Rb^Gvs, Re^Vhr, Rb^Gvs, Rb^Gvs, Rb^Gvs, Rb^Gvs
Hh, Hh, Gs, Hh, Gs, Gs, Gs, Re^Vhr, Rb^Gvs, Rb^Gvs, Rb^Gvs, Re, Re, Rb^Gvs, Ch^Qhux, Ch^Qhux, Rr, Rr, Rr^Vhc, Rr, Gs^Fds, Ch, Rr^Vhc, Rr, Rr^VjD, Rr^VjB, Rr^VjE, Rp, Rp, Rr, Rr^VjD, Rr^VjD, Gs^Fds, Rp, Rp, Rr, Isa, Rr^VjB, Rr^VjE, Rr, Rr, Ch^Qhux, Ch^Qhux, Rb^Gvs, Rb^Gvs, Rb^Gvs, Ch^Qhux, Ch^Qhux, Ch^Qhux, Rb^Gvs, Rb^Gvs, Rb^Gvs, Rb^Gvs, Rb^Gvs, Gs^Fds, Rb^Gvs, Rb^Gvs, Re, Rb^Gvs, Rb^Gvs, Rb^Gvs, Rb^Gvs
Gg, Gg, Gg, Gs, Gll^Fms, Gs, Gs^Fds, Rb^Gvs, Rb^Gvs, Rb^Gvs, Rb^Gvs, Rb^Gvs, Re, Ch^Qhux, Rr, Rr, Kh, Ch, Ch, Ch, Gg, Ch, Gs^Fds, Rr, Rr^VjD, Gs^Fds, Rp, Rr^VjA, Rr^VjD, Rr^VjD, Gs^Fms, Rr^Vhc, Rr, Rr, Rr^VjD, Rr^Vhc, Isa, Rr^VjD, Rr, Rr^Vhc, Rr^VjC, Rr^VjD, Rr, Ch^Qhux, Ch^Qhux, Ch^Qhux, Rr, Rr, Rr, Ch^Qhux, Ch^Qhux, Rb^Gvs, Rb^Gvs, Gs^Fds, Rb^Gvs, Rb^Gvs, Rb^Gvs, Re^Edt, Rb^Gvs, Rb^Gvs, Gs^Fds, Gs^Fds
Gg, Gg, Gs^Fds, Gs^Fds, Gs^Fds, Gs^Fds, Gs^Fds, Rb^Gvs, Rb^Gvs, Rb^Gvs, Rb^Gvs, Rb^Gvs, Gg, Ch^Qhux, Rr, Kh, 7 Kh, Kh, Ch, Gg, Gg, Ch, Gs^Fds, Rp, Rr^VjB, Rr, Rr^Vhc, Rr, Rr, Rr, Rr, Rp, Rr, Rr^VjD, Rr^VjD, Isa, Rr^VjA, Rr^VjE, Rp, Rr, Rr^VjE, Rr^VjD, Rr, Rr, Rr, Rr, Ch, Ch, Ch, Rp, Ch^Qhux, Rb^Gvs, Rb^Gvs, Rb^Gvs, Rb^Gvs, Rb^Gvs, Rb^Gvs, Re, Gs^Fds, Gs^Fms, Gs^Fds, Gs^Fds
Gg, Gg, Gg, Gg^Fms, Gs^Fds, Gll^Fms, Rb^Gvs, Rb^Gvs, Rb^Gvs, Rb^Gvs, Rb^Gvs, Rb^Gvs, Gg, Ch^Qhux, Rr, Kh, Kh, Ch, Ch, Gg^Efm, Gg^Efm, Ch, Rr^Vhc, Rr, Rr^VjD, Rr, Rr, Rr, Rr^VjD, Rr^VjC, Rr^Es, Rr, Rr^Es, Rr^VjD, Rr^Vhc, Isa, Rr^VjE, Rp, Rr^VjD, Rr^Vhc, Rr^Es, Rr, Rr^VjD, Rr^VjD, Rr^VjC, Rp, Ch, 6 Kh, Ch, Rr, Ch^Qhux, Rb^Gvs, Rb^Gvs, Rb^Gvs, Rb^Gvs, Rb^Gvs, Rb^Gvs, Re, Gs^Efm, Gs^Fds, Gs^Fms, Gs^Fms
Gg, Gg, Gg, Hh, Hh, Hh, Hh, Rb^Gvs, Hh, Rb^Gvs, Gs^Fds, Gg, Gg, Ch^Qhux, Rr, Ch, Ch, Ch, Gg^Efm, Isa, Isa, Ch, Ch, Rr, Rr^VjD, Gs^Fds, Rr^VjD, Rr^VjD, Rp, Rp^Es, Rr^VjD, Rr^VjE, Rr^Es, Rr^Dr, Rr^Dr, Isa^Es, Rr^VjD, Rr^VjD, Isa^Es, Rr^Dr, Rr^VjA, Rr^Vhc, Isa, Rr^VjE, Isa, Isa, Rp, Ch, Rr, Rr, Ch^Qhux, Rb^Gvs, Rb^Gvs, Rb^Gvs, Rb^Gvs, Rb^Gvs, Rb^Gvs, Re^Vhr, Gs^Fds, Gs^Fds, Rb^Gvs, Rb^Gvs
Gs^Fds, Gs^Fds, Hh, Hh, Hh, Hh^Fds, Hh, Hh, Gg, Gs^Fms, Gg, Gg, Ch^Qhux, Ch^Qhux, Rr, Rr^Vhc, Ch, Gg, Gg, Gg^Efm, Ch, Isa, Isa, Rr, Rr^VjD, Rr^VjB, Rr, Rr, Rr^VjB, Rr^Vhc, Gs^Fds, Rr, Rr, Rr^VjA, Rr^VjD, Isa^Es, Isa^Es, Isa, Rr^VjD, Isa^Es, Isa, Isa, Rr^VjB, Isa, Rr^VjD, Rr^VjC, Re^VjJ, Rr, Re^VjJ, Re^Edt, Ch^Qhux, Rb^Gvs, Rb^Gvs, Rb^Gvs, Rb^Gvs, Rb^Gvs, Rb^Gvs, Re, Rb^Gvs, Rb^Gvs, Rb^Gvs, Rb^Gvs
Gg, Gs^Fds, Gg, Hh, Gs^Fds, Hh, Gs^Fds, Hh, Rb^Gvs, Gg, Gg, Ch^Qhux, Rr, Rr, Rr, Rr, Gs^Fds, Gg, Ch, Ch, Rr^Vhc, Ch, Rp, Isa, Isa, Rr^Es, Rr^VjD, Rr^VjA, Gs^Fds, Rr^VjD, Rr, Rr, Rr^Vhc, Rr^VjC, Isa, Isa, Rr^VjC, Rr^VjB, Rp, Rp, Re^VjH, Rr^VjC, Rp, Re^VjH, Re, Re, Re^VjL, Re^Vh, Rb, Re, Ch^Qhux, Rb^Gvs, Rb^Gvs, Rb^Gvs, Rb^Gvs, Rb^Gvs, Rb^Gvs, Re^Edt, Re^Edt, Rb^Gvs, Rb^Gvs, Rb^Gvs
Gg, Gg, Gg, Gg, Gg, Gg, Gg, Gs^Fds, Rb^Gvs, Rb^Gvs, Rb^Gvs, Ch^Qhux, Rr, Rr, Rr, Ch, Ch, Ch, Gs^Fms, Gs^Fds, Rr, Rp, Rr^VjA, Rr^VjB, Rr^Vhc, Isa, Isa, Rr^VjA, Rr^Vhc, Rp, Gs^Fms, Rr^VjC, Isa, Isa, Rr^VjB, Rr^VjD, Rp, Re, Rr^VjB, Re^Edt, Re^Edt, Rp, Re, Re, Re^VjL, Re^VjO, Re^VjH, Rb, Re^VjM, Re, Re, Ch^Qhux, Ch^Qhux, Rb^Gvs, Rb^Gvs, Rb^Gvs, Rb^Gvs, Rb^Gvs, Rb^Gvs, Re, Rb^Gvs, Rb^Gvs
Rb^Gvs, Rb^Gvs, Rb^Gvs, Rb^Gvs, Rb^Gvs, Re, Gs^Fds, Gg, Rb^Gvs, Rb^Gvs, Rb^Gvs, Ch^Qhux, Rr, Rr^VjB, Rp, Rr^Vhc, Ch, Rr^Vhc, Rp, Rr, Rr^VjA, Rr^VjD, Rr, Rr, Rr, Rr^VjC, Rr^VjD, Isa, Isa, Rr^VjB, Rr^VjD, Rr^VjD, Isa, Rr^VjD, Rp, Rp, Re, Rr^Vhc, Re, Re^Edt, Re^VjH, Re^VjN, Re^Vh, Re, Re^Edt, Re^Edt, Re^VjH, Re^Vh, Rb, Re^VjH, Re^VjJ, Re, Ch^Qhux, Rb^Gvs, Rb^Gvs, Rb^Gvs, Rb^Gvs, Rb^Gvs, Rb^Gvs, Re, Re, Gg
Rb^Gvs, Rb^Gvs, Rb^Gvs, Rb^Gvs, Rb^Gvs, Gs^Fds, Gs^Fds, Rb^Gvs, Rb^Gvs, Rb^Gvs, Rb^Gvs, Ch^Qhux, Rr, Rr^VjD, Rr, Rr, Rp, Rr, Rr^Es, Rr^Dr, Rr, Rr^VjD, Rr^VjA, Gs^Fms, Rr^Vhc, Rp, Rp, Rr^VjA, Rr^VjD, Isa, Isa, Rr^Vhc, Isa, Rr^VjE, Rr^VjD, Rr^Vhc, Re^Edt, Re, Re^Vh, Re^VjH, Rb, Rb, Re^VjJ, Re^VjN, Re, Re^VjH, Rb, Rb, Re^VjN, Rb, Re^Vh, Re, Ch^Qhux, Rb^Gvs, Rb^Gvs, Rb^Gvs, Rb^Gvs, Rb^Gvs, Gs^Eff, Gs^Eff, Re, Gg
Rb^Gvs, Rb^Gvs, Rb^Gvs, Rb^Gvs, Rb^Gvs, Rb^Gvs, Rb^Gvs, Rb^Gvs, Rb^Gvs, Rb^Gvs, Re, Ch^Qhux, Rr, Rr^VjD, Rr^VjD, Rr, Rr, Rp, Rr^Es, Rp^Es, Rr^VjD, Rr, Gs^Fds, Rr, Rr, Gs^Fds, Rr, Rr, Rr, Rr^Vhc, Rr^VjB, Isa, 1 Isa, Isa, Rr^Vhc, Rp, Rp, Re, Rb^Edt, Rb, Re^VjH, Re^VjJ, Rb, Re, Re^VjH, Re, Re, Re^VjM, Rb^Edt, Rb^Edt, Re^VjH, Re, Ch^Qhux, Rb^Gvs, Rb^Gvs, Rb^Gvs, Gs^Fds, Gs^Fds, Gs^Fds, Gs^Fds, Ww, Gg
Rb^Gvs, Rb^Gvs, Rb^Gvs, Rb^Gvs, Rb^Gvs, Rb^Gvs, Rb^Gvs, Rb^Gvs, Gs^Eff, Gs^Eff, Gg, Ch^Qhux, Ch^Qhux, Rp, Rr, Rr^VjC, Rr^VjB, Rr^VjB, Rr^Dr, Rr^VjD, Rr^VjD, Gs^Fds, Gs^Fds, Gs^Fms, Rp^Es, Rr^VjD, Rr^VjC, Rr, Rr^VjD, Rr^VjE, Isa, Isa, Isa, Isa, Isa, Rp, Rr^VjB, Re^VjH, Re^Edt, Re, Rb^Edt, Rb, Re^VjJ, Re^Vh, Re^Edt, Re, Re^VjH, Re, Re^Edt, Re^VjH, Re, Re, Ch^Qhux, Rb^Gvs, Gs^Eff, Gs^Eff, Gs^Fds, Ww, Wo, Ww, Ww, Ww
Rb^Gvs, Rb^Gvs, Rb^Gvs, Rb^Gvs, Rb^Gvs, Re^Vhr, Gs^Eff, Gs^Eff, Gg, Gg, Gg, Gg, Gg, Ch^Qhux, Xos, Rr, Rr, Rp, Isa, Rr, Isa, Rr^VjD, Rr^VjE, Rr^VjD, Isa^Es, Rr^Dr, Isa, Rr^VjC, Isa, Isa, Rr^VjD, Rr^Vhc, Isa, Rr^VjB, Rr^VjD, Isa, Isa, Rr^VjD, Rr^Vhc, Rp, Re^VjJ, Re, Re, Re, Re^VjM, Rb^Edt, Rb, Re^VjO, Re, Rb, Rb^Edt, Re^Edt, Ch^Qhux, Gs, Gll^Fp, Gs^Fds, Gg^Efm, Ww, Wo, Wo, Gs^Fms, Gg
Rb^Gvs, Rb^Gvs, Rb^Gvs, Rb^Gvs, Rb^Gvs, Rb^Gvs, Rb^Gvs, Gs^Eff, Gs^Eff, Gg, Gg, Gg, Gg, Gg, Gg, Rr^Pr\, Rr^Pr\, Isa, Rr, Isa, Gs^Fds, Isa, Isa, Isa, Rr^VjD, Isa^Es, Rr^VjD, Isa, Rr^VjA, Rr^VjD, Rr, Rr^VjB, Isa, Rr^VjC, Rr, Rr^VjD, Rr^Dr, Isa, Isa, Rr^VjE, Rr^Vhc, Rp, Rp, Re^VjH, Rb, Rb^Edt, Rb, Re, Re^VjJ, Rb, Ch^Qhux, Ch^Qhux, Gs^Fds, Gll^Fp, Gll^Fp, Gs^Fds, Gg^Efm, Ww, Gs^Fds, Ww, Gs^Fds, Gs^Fds
Rb^Gvs, Rb^Gvs, Rb^Gvs, Rb^Gvs, Rb^Gvs, Rb^Gvs, Rb^Gvs, Rb^Gvs, Rb^Gvs, Gs^Eff, Gs^Eff, Gg, Gg, Gg, Rr, Rr, Gg, Rr^Pr\, Xos, Rp, Rr, Gs^Fds, Rr^VjD, Rr^VjD, Rr, Rr^VjD, Rp^Es, Rp^Es, Rr, Rr, Rr, Rr^VjE, Isa, Rr^VjE, Rr, Rr, Rr, Rr^VjE, Rr^VjC, Isa, Isa, Rr^Vhc, Rr^VjA, Re, Re^VjL, Re^VjO, Rb, Re^Vh, Re^VjN, Re, Ch^Qhux, Gs^Fds, Gs^Fms, Gs^Fms, Gs^Eff, Gs^Eff, Gs^Eff, Gs^Eff, Gs^Eff, Gs^Fds, Gll^Fms, Gs^Fms
Rb^Gvs, Rb^Gvs, Rb^Gvs, Rb^Gvs, Rb^Gvs, Rb^Gvs, Rb^Gvs, Rb^Gvs, Rb^Gvs, Rb^Gvs, Gs^Eff, Gg^Eff, Rr, Rr, Gg, Gg, Gg, Gg, Gg, Ch^Qhux, Ch^Qhux, Rp, Rr, Rr^Vhc, Rr^Vhc, Rr, Rr^Dr, Rr^Es, Rr^VjB, Rp, Rr, Rr^VjD, Isa, Rr^Dr, Gs^Fms, Gs^Fds, Rr^Vhc, Rr^VjD, Re^Edt, Rp, Rr^VjA, Isa, Isa, Rr^VjA, Rr, Re^Vh, Re^VjH, Re, Re^Edt, Re, Ch^Qhux, Gs^Fds, Gs^Eff, Gs^Eff, Rb^Gvs, Rb^Gvs, Rb^Gvs, Rb^Gvs, Rb^Gvs, Gs^Eff, Gs^Fds, Gs^Fds
Rb^Gvs, Rb^Gvs, Re^Vct, Rb^Gvs, Re^Vct, Re^Ecf, Rb^Gvs, Rb^Gvs, Gs^Eff, Gs^Eff, Rr, Rr, Gg, Re, Gs^Vh, Gs^Fds, Gs^Fds, Gg, Gg, Gg, Gg, Ch^Qhux, Ch^Qhux, Rr, Rp, Rr^VjE, Rr^Dr, Rr^VjA, Rr^Vhc, Rp, Rr, Gs^Fds, Isa, Rr^VjA, Rr^VjD, Rr^VjB, Re, Re, Re^Edt, Re, Re^VjJ, Rr^Vhc, Rr^VjA, Isa, Isa, Rr, Rr^VjD, Re, Re^VjH, Re, Ch^Qhux, Gs^Fds, Rb^Gvs, Rb^Gvs, Rb^Gvs, Rb^Gvs, Rb^Gvs, Rb^Gvs, Gs^Wm, Gs^Fds, Gs^Fds, Gs^Fds
Rb^Gvs, Rb^Gvs, Re, Re^Edt, Re^Edt, Re^Vct, Gs^Eff, Gs^Eff, Rr, Rr, Gg, Gg, Gs, Gg, Gg, Gg, Gs^Fms, Gs^Fds, Gg, Gg, Ch^Qhux, Ch^Qhux, Rr, Rr, Rr^VjD, Rr^Es, Rr^Es, Rr^Es, Gs^Fds, Rr^Vhc, Rr^VjD, Gs^Fds, Rr^VjD, Isa, Isa, Rp, Re^VjN, Re^VjM, Re^Vh, Re, Rb, Re, Re, Rr^VjD, Rr^Vhc, Isa, Isa, Rp, Rp, Rp, Xos, Gg, Rb^Gvs, Rb^Gvs, Rb^Gvs, Rb^Gvs, Re, Re, Rb^Gvs, Gs, Rb^Gvs, Gs^Fds
Rb^Gvs, Rb^Gvs, Co, Co, Co^Edt, Gs, Rr, Rr, Gg, Gg, Gg, Gs, Gs^Fms, Gs^Fms, Gs^Fds, Gg, Gs^Fms, Gg, Ch^Qhux, Ch^Qhux, Rr, Rr, Rr^VjD, Rr^Vhc, Rr^Es, Rr, Rr^VjD, Rr, Rr, Gs^Fms, Rr, Rr, Rr, Rr^VjE, Rr^VjE, Isa, Rb^Edt, Rb^Edt, Re^VjJ, Rb, Rb, Re^VjJ, Re^Edt, Re^Edt, Re^VjJ, Rr^VjD, Rp, Isa, Rr^Pr/, Rr^Pr/, Gg, Gg, Re, Re^Vhr, Re, Re, Rb^Gvs, Rb^Gvs, Rb^Gvs, Rb^Gvs, Rb^Gvs, Rb^Gvs
Rb^Gvs, Rb^Gvs, Gs, Co, Co^Edt, Rr, Re^Edt, Re^Vct, Re^Ecf, Gg, Gg, Gs^Fds, Re, Gs^Fds, Re, Gs^Fds, Ch^Qhux, Ch^Qhux, Rp, Rr, Rr^VjD, Rr^Vhc, Rp, Rr^Es, Rr^Dr, Rr^Vhc, Rr, Rr^Vhc, Rr^VjD, Rp, Rr^VjD, Rr^Vhc, Rr, Rr, Rr^VjD, Isa, Re^VjJ, Rb, Re^VjJ, Re, Re^VjJ, Re, Re^Vh, Re^VjN, Re, Re, Xos, Rr^Pr/, Gg, Rr, Rr, Gg, Re, Re, Rb^Gvs, Rb^Gvs, Rb^Gvs, Rb^Gvs, Rb^Gvs, Rb^Gvs, Rb^Gvs, Rb^Gvs
Gs, Gs, Rr, 4 Ko, Co^Edt, Co^Edt, Re^Edt, Re^Vct, Gg, Gg, Re^Eff, Re^Eff, Rb^Gvs, Re, Rb^Gvs, Ch^Qhux, Ch^Qhux, Rr, Rr, Rr^VjD, Rr^Vhc, Rr, Rr^VjB, Rr^Vhc, Rr^Es, Rr^Es, Rr^VjD, Rr, Rr, Rr, Rr, Rr^VjD, Rr, Rp, Rr^VjD, Isa, Rr^Vh, Re^VjM, Re^VjJ, Rb^Edt, Re^VjM, Re^VjM, Re, Re^Edt, Ch^Qhux, Ch^Qhux, Gg, Gg, Gg, Gg, Re^Eff, Rr, Rr, Re^Eff, Re^Eff, Rb^Gvs, Rb^Gvs, Rb^Gvs, Rb^Gvs, Rb^Gvs, Rb^Gvs, Rb^Gvs
Rr, Rr, Re^Edt, Re^Edt, Co^Edt, Co^Edt, Gg, Gg, Re^Eff, Re^Eff, Rb^Gvs, Rb^Gvs, Rb^Gvs, Rb^Gvs, Rb^Gvs, Rb^Gvs, Rb^Gvs, Ch^Qhux, Ch^Qhux, Rr, Rp, Rr^VjD, Rr, Rr, Rr, Rr^VjD, Rr^VjE, Rr^Vhc, Rr^Vhc, Gs^Fds, Rr, Rr^Vhc, Rr^VjD, Rr^VjA, Isa, Isa, Rp, Re^VjJ, Rb, Rb^Edt, Re, Re, Ch^Qhux, Ch^Qhux, Re, Re, Re^Eff, Re^Eff, Re^Eff, Re^Eff, Rb^Gvs, Re^Eff, Re^Eff, Rr, Rr, Re^Eff, Re^Eff, Rb^Gvs, Rb^Gvs, Rb^Gvs, Rb^Gvs, Rb^Gvs
Gs, Gs, Re^Vct, Re^Edt, Gg, Re^Edt, Re^Vct, Gs, Re, Re^Eff, Gs^Fds, Rb^Gvs, Rb^Gvs, Rb^Gvs, Rb^Gvs, Rb^Gvs, Rb^Gvs, Rb^Gvs, Rb^Gvs, Ch^Qhux, Ch^Qhux, Rr, Ch^Qhux, Ch^Qhux, Ch^Qhux, Rr, Rr, Rr^VjA, Rr^VjD, Rr^VjE, Rr, Rr^VjD, Isa, Isa, Rr^Vhc, Rr^VjA, Re^Edt, Re^Edt, Re^Vh, Re^VjN, Ch^Qhux, Ch^Qhux, Re, Re, Re^Eff, Re^Eff, Rb^Gvs, Rb^Gvs, Rb^Gvs, Rb^Gvs, Rb^Gvs, Rb^Gvs, Re, Re^Eff, Re, Rr, Rr, Re^Eff, Re, Rb^Gvs, Rb^Gvs, Rb^Gvs
Gg, Gs, Re^Ecf, Re^Vct, Gs^Fms, Gg, Gs, Gs^Fms, Gs^Fms, Gs^Fds, Rb^Gvs, Rb^Gvs, Rb^Gvs, Rb^Gvs, Rb^Gvs, Rb^Gvs, Rb^Gvs, Rb^Gvs, Rb^Gvs, Gs^Fds, Gs^Fds, Ch^Qhux, Gs^Fms, Gs^Fds, Gs^Fds, Ch^Qhux, Ch^Qhux, Rr, Rr, Rp, Rr^VjD, Rr^Dr, Isa, Rr^VjC, Rr^VjD, Rr^VjC, Re, Re^VjJ, Ch^Qhux, Ch^Qhux, Re, Re, Re^Eff, Re^Eff, Rb^Gvs, Rb^Gvs, Rb^Gvs, Rb^Gvs, Rb^Gvs, Rb^Gvs, Re, Re, Rb^Gvs, Re^Vhr, Rb^Gvs, Re^Eff, Re^Eff, Rr, Rr, Re^Eff, Re^Eff, Rb^Gvs
Gg, Gg, Gg, Gs^Fms, Gs^Fms, Gg, Re, Gs^Fds, Gs^Fds, Gs^Fds, Rb^Gvs, Rb^Gvs, Re^Eff, Re^Eff, Re^Eff, Rb^Gvs, Gs^Fds, Rb^Gvs, Rb^Gvs, Gs^Fms, Rb^Gvs, Gs^Fds, Rb^Gvs, Rb^Gvs, Rb^Gvs, Gs^Fds, Gs^Fms, Ch^Qhux, Ch^Qhux, Rr, Rr, Rr^VjA, Isa, Rr^VjE, Re^Edt, Re, Ch^Qhux, Ch^Qhux, Gs^Fds, Re, Rb^Gvs, Re^Eff, Re^Eff, Rb^Gvs, Rb^Gvs, Rb^Gvs, Rb^Gvs, Rb^Gvs, Re, Re, Rb^Gvs, Rb^Gvs, Rb^Gvs, Rb^Gvs, Re^Vct, Re^Vct, Re^Edt, Re, Ce, Rr, Rr, Re^Eff
Gs^Fds, Gg, Gs^Fds, Gg, Gg, Gs, Re, Re, Re^Eff, Rb^Gvs, Re^Eff, Re^Eff, Re^Vhr, Re, Re, Re^Eff, Re^Eff, Gs^Fds, Rb^Gvs, Rb^Gvs, Rb^Gvs, Rb^Gvs, Rb^Gvs, Rb^Gvs, Rb^Gvs, Rb^Gvs, Rb^Gvs, Gs^Fms, Gs^Fds, Ch^Qhux, Rr, Rp, Ch, Rp, Rp, Ch^Qhux, Gs^Fds, Gs^Fds, Gs^Fms, Rb^Gvs, Rb^Gvs, Rb^Gvs, Rb^Gvs, Re^Eff, Re^Eff, Re^Vhr, Re, Re, Rb^Gvs, Rb^Gvs, Rb^Gvs, Rb^Gvs, Re^Vct, Re^Ecf, Re, Re^Edt, Ce, Ce, Ce, Ce, Re^Eff, Rr
Gs^Fds, Gs^Fds, Gs^Fms, Gs^Fds, Rb^Gvs, Gs, Rb^Gvs, Re, Re, Re^Eff, Re, Re, Re^Eff, Re^Eff, Re^Eff, Re, Re, Re^Eff, Re^Wm, Rb^Gvs, Rb^Gvs, Rb^Gvs, Rb^Gvs, Rb^Gvs, Rb^Gvs, Rb^Gvs, Rb^Gvs, Rb^Gvs, Rb^Gvs, Ch^Qhux, Rr, Ch, 5 Kh, Ch, Rp, Ch^Qhux, Gs^Fds, Gs^Fds, Rb^Gvs, Rb^Gvs, Rb^Gvs, Rb^Gvs, Rb^Gvs, Rb^Gvs, Re, Re, Re^Eff, Rb^Gvs, Rb^Gvs, Rb^Gvs, Rb^Gvs, Re^Vct, Re^Edt, Re, Ce, Ce, Ce, 3 Ke, Re, Re, Re^Vct, Re^Eff
Gs^Fds, Gs^Fms, Gs^Fds, Gs^Fds, Rb^Gvs, Rb^Gvs, Rb^Gvs, Rb^Gvs, Re, Re, Re^Eff, Re^Eff, Rb^Gvs, Rb^Gvs, Rb^Gvs, Re^Eff, Re^Eff, Re, Re, Rb^Gvs, Rb^Gvs, Rb^Gvs, Rb^Gvs, Rb^Gvs, Rb^Gvs, Rb^Gvs, Rb^Gvs, Rb^Gvs, Rb^Gvs, Ch^Qhux, Rr, Ch, Ch, Ch, Rr, Ch^Qhux, Gs^Fds, Gs^Fms, Rb^Gvs, Rb^Gvs, Rb^Gvs, Rb^Gvs, Rb^Gvs, Rb^Gvs, Re, Gs^Fds, Gs^Fds, Re^Eff, Re^Eff, Rb^Gvs, Rb^Gvs, Re^Ecf, Re^Vct, Re^Edt, Re, Ce, Re^Edt, Re, Re^Ecf, Re^Vct, Gs^Fds, Gs^Fds
Gs^Fds, Gs^Fds, Gs, Gs^Fms, Gs, Rb^Gvs, Re, Re, Re^Eff, Re^Eff, Rb^Gvs, Rb^Gvs, Rb^Gvs, Rb^Gvs, Rb^Gvs, Rb^Gvs, Rb^Gvs, Re^Eff, Re, Rb^Gvs, Rb^Gvs, Rb^Gvs, Rb^Gvs, Rb^Gvs, Rb^Gvs, Rb^Gvs, Rb^Gvs, Rb^Gvs, Rb^Gvs, Ch^Qhux, Ch^Qhux, Rp, Rp, Rp, Ch^Qhux, Ch^Qhux, Gs^Fms, Rb^Gvs, Rb^Gvs, Rb^Gvs, Rb^Gvs, Rb^Gvs, Re, Re, Rb^Gvs, Rb^Gvs, Rb^Gvs, Gs^Fds, Gs^Fds, Re^Eff, Re^Eff, Rb^Gvs, Rb^Gvs, Re^Vct, Rb^Gvs, Re, Re^Vct, Re^Vct, Gs^Fds, Rb^Gvs, Rb^Gvs, Rb^Gvs
Gll^Fp, Gg, Gs, Gs, Rb^Gvs, Rb^Gvs, Re, Re^Eff, Rb^Gvs, Rb^Gvs, Rb^Gvs, Rb^Gvs, Rb^Gvs, Rb^Gvs, Re, Rb^Gvs, Rb^Gvs, Rb^Gvs, Re, Gs^Fds, Rb^Gvs, Rb^Gvs, Rb^Gvs, Rb^Gvs, Rb^Gvs, Rb^Gvs, Rb^Gvs, Rb^Gvs, Rb^Gvs, Rb^Gvs, Rb^Gvs, Ch^Qhux, Ch^Qhux, Ch^Qhux, Rb^Gvs, Rb^Gvs, Re^Eff, Rb^Gvs, Rb^Gvs, Rb^Gvs, Re, Re, Rb^Gvs, Re, Re, Rb^Gvs, Re^Vhr, Rb^Gvs, Re^Eff, Re^Eff, Rb^Gvs, Re^Eff, Re^Eff, Rb^Gvs, Rb^Gvs, Rb^Gvs, Gs^Fds, Gs^Fms, Gs^Fds, Rb^Gvs, Rb^Gvs, Rb^Gvs
Gg, Gg, Gs, Gs, Re^Eff, Re^Eff, Re^Vhr, Rb^Gvs, Rb^Gvs, Rb^Gvs, Rb^Gvs, Rb^Gvs, Re, Re, Rb^Gvs, Re, Re, Rb^Gvs, Re, Gs^Fms, Gs^Fds, Rb^Gvs, Rb^Gvs, Rb^Gvs, Rb^Gvs, Rb^Gvs, Rb^Gvs, Rb^Gvs, Rb^Gvs, Rb^Gvs, Rb^Gvs, Rb^Gvs, Rb^Gvs, Rb^Gvs, Rb^Gvs, Rb^Gvs, Rb^Gvs, Re^Eff, Re, Re, Rb^Gvs, Rb^Gvs, Rb^Gvs, Rb^Gvs, Rb^Gvs, Re, Re, Re^Eff, Rb^Gvs, Rb^Gvs, Rb^Gvs, Rb^Gvs, Rb^Gvs, Re, Re^Eff, Re^Vhr, Rb^Gvs, Rb^Gvs, Rb^Gvs, Rb^Gvs, Rb^Gvs, Rb^Gvs
Gs^Fds, Gg, Gg, Gg, Gg, Re^Eff, Re^Eff, Rb^Gvs, Rb^Gvs, Rb^Gvs, Re, Re, Rb^Gvs, Rb^Gvs, Rb^Gvs, Rb^Gvs, Rb^Gvs, Re, Re, Gs^Fds, Re, Gs^Fds, Rb^Gvs, Rb^Gvs, Rb^Gvs, Rb^Gvs, Rb^Gvs, Rb^Gvs, Rb^Gvs, Rb^Gvs, Rb^Gvs, Rb^Gvs, Rb^Gvs, Rb^Gvs, Rb^Gvs, Rb^Gvs, Re, Re, Rb^Gvs, Re^Eff, Re^Eff, Rb^Gvs, Rb^Gvs, Rb^Gvs, Re^Eff, Re^Eff, Rb^Gvs, Re, Re, Rb^Gvs, Rb^Gvs, Rb^Gvs, Rb^Gvs, Rb^Gvs, Rb^Gvs, Re^Eff, Re^Eff, Rb^Gvs, Rb^Gvs, Rb^Gvs, Rb^Gvs, Rb^Gvs
Gs^Fds, Gs^Fds, Gs^Fds, Gg, Gg, Gs, Gs, Re^Eff, Re, Re, Rb^Gvs, Rb^Gvs, Rb^Gvs, Rb^Gvs, Rb^Gvs, Rb^Gvs, Rb^Gvs, Rb^Gvs, Rb^Gvs, Re^Vhr, Rb^Gvs, Re, Re, Re, Re, Rb^Gvs, Re, Re, Re, Rb^Gvs, Rb^Gvs, Rb^Gvs, Gs^Fds, Gs^Fds, Rb^Gvs, Re, Rb^Gvs, Rb^Gvs, Rb^Gvs, Rb^Gvs, Rb^Gvs, Re^Wm, Gs^Fds, Re^Eff, Rb^Gvs, Rb^Gvs, Rb^Gvs, Rb^Gvs, Rb^Gvs, Re, Re, Rb^Gvs, Rb^Gvs, Rb^Gvs, Re^Eff, Re^Eff, Rb^Gvs, Re^Eff, Re^Eff, Rb^Gvs, Rb^Gvs, Rb^Gvs
Gll^Fp, Gll^Fp, Gg, Gg, Gg, Gg, Gs, Re, Gs, Re^Eff, Re^Eff, Rb^Gvs, Rb^Gvs, Rb^Gvs, Rb^Gvs, Rb^Gvs, Rb^Gvs, Rb^Gvs, Rb^Gvs, Rb^Gvs, Rb^Gvs, Rb^Gvs, Rb^Gvs, Rb^Gvs, Rb^Gvs, Re, Rb^Gvs, Rb^Gvs, Rb^Gvs, Re^Vhr, Re, Re, Re, Gs^Fds, Gs^Fds, Re, Rb^Gvs, Rb^Gvs, Rb^Gvs, Rb^Gvs, Rb^Gvs, Rb^Gvs, Rb^Gvs, Gs^Fms, Gs^Fds, Rb^Gvs, Rb^Gvs, Rb^Gvs, Rb^Gvs, Rb^Gvs, Rb^Gvs, Re, Re, Re^Eff, Rb^Gvs, Rb^Gvs, Rb^Gvs, Rb^Gvs, Rb^Gvs, Re, Re^Eff, Rb^Gvs
Gll^Fp, Gs^Fds, Gll, Gg, Gll, Gg, Gg, Gg, Gg, Gs, Gg, Re^Eff, Re^Eff, Rb^Gvs, Rb^Gvs, Gs^Fds, Gs^Fds, Gs, Gs, Rb^Gvs, Rb^Gvs, Rb^Gvs, Rb^Gvs, Rb^Gvs, Rb^Gvs, Rb^Gvs, Rb^Gvs, Rb^Gvs, Rb^Gvs, Rb^Gvs, Rb^Gvs, Rb^Gvs, Rb^Gvs, Re, Re, Re, Re^Vhr, Rb^Gvs, Rb^Gvs, Rb^Gvs, Rb^Gvs, Rb^Gvs, Rb^Gvs, Rb^Gvs, Rb^Gvs, Gs^Fds, Gs^Fms, Rb^Gvs, Rb^Gvs, Rb^Gvs, Re^Eff, Re^Eff, Rb^Gvs, Re^Vhr, Re, Rb^Gvs, Rb^Gvs, Rb^Gvs, Rb^Gvs, Rb^Gvs, Rb^Gvs, Re^Eff
Gll^Fp, Gll^Fp, Gll^Em, Gll, Gll, Gll^Fp, Gll^Fp, Gg, Gs^Fms, Gg, Gll, Gg, Gg, Re^Eff, Re^Eff, Gs^Fds, Gs^Fds, Gs, Gs, Gs, Rb^Gvs, Rb^Gvs, Rb^Gvs, Rb^Gvs, Rb^Gvs, Rb^Gvs, Rb^Gvs, Rb^Gvs, Rb^Gvs, Rb^Gvs, Rb^Gvs, Rb^Gvs, Rb^Gvs, Gs^Fds, Gs^Fds, Re, Rb^Gvs, Rb^Gvs, Rb^Gvs, Rb^Gvs, Rb^Gvs, Rb^Gvs, Rb^Gvs, Rb^Gvs, Rb^Gvs, Rb^Gvs, Rb^Gvs, Gs^Fds, Re^Eff, Re^Eff, Rb^Gvs, Rb^Gvs, Rb^Gvs, Rb^Gvs, Re, Rb^Gvs, Rb^Gvs, Rb^Gvs, Rb^Gvs, Rb^Gvs, Rb^Gvs, Rb^Gvs
Gll^Fp, Gll^Em, Gll, Gll^Em, Gs^Fms, Gll^Fp, Gll^Fp, Gs^Fms, Gll^Em, Gll, Gll, Gg, Gs^Fms, Gll, Gll^Fp, Gll^Fp, Gs^Fms, Gs^Fds, Gll, Gs, Gs^Fds, Gs^Fds, Rb^Gvs, Rb^Gvs, Rb^Gvs, Rb^Gvs, Rb^Gvs, Rb^Gvs, Rb^Gvs, Rb^Gvs, Rb^Gvs, Rb^Gvs, Rb^Gvs, Rb^Gvs, Gs^Fds, Re, Rb^Gvs, Rb^Gvs, Rb^Gvs, Rb^Gvs, Rb^Gvs, Rb^Gvs, Rb^Gvs, Rb^Gvs, Rb^Gvs, Rb^Gvs, Re^Eff, Re^Eff, Rb^Gvs, Rb^Gvs, Rb^Gvs, Rb^Gvs, Rb^Gvs, Rb^Gvs, Re, Rb^Gvs, Rb^Gvs, Rb^Gvs, Rb^Gvs, Rb^Gvs, Rb^Gvs, Rb^Gvs
Gll^Fp, Gll^Fp, Gll^Fp, Gll^Fp, Gs^Fms, Gll^Fp, Gs^Fms, Gs^Fms, Gs^Fms, Gs^Fms, Gg, Gll, Gs^Fms, Gs^Fms, Gs^Fms, Gll^Fp, Gs^Fms, Gll, Gll, Gll, Gll^Fds, Gs^Fds, Rb^Gvs, Rb^Gvs, Rb^Gvs, Rb^Gvs, Rb^Gvs, Rb^Gvs, Rb^Gvs, Rb^Gvs, Rb^Gvs, Rb^Gvs, Rb, Rb^Gvs, Gs^Fds, Re, Rb^Gvs, Rb^Gvs, Rb^Gvs, Rb^Gvs, Rb^Gvs, Rb^Gvs, Rb^Gvs, Rb^Gvs, Re^Eff, Re^Eff, Rb^Gvs, Rb^Gvs, Rb^Gvs, Rb^Gvs, Rb^Gvs, Rb^Gvs, Rb^Gvs, Rb^Gvs, Re, Rb^Gvs, Rb^Gvs, Rb^Gvs, Rb^Gvs, Rb^Gvs, Rb^Gvs, Rb^Gvs
