Gs^Fds, Gs^Fds, Gs^Fds, Gs^Fds, Gs^Fds, Gs^Fds, Gs^Fds, Gs^Fms, Gs^Fds, Gs^Fms, Gs^Fds, Gg, Gg, Ww, Gg, Gg, Gs^Fds, Gs^Fms, Gs^Fds, Gll^Fp, Gg, Gg, Gg, Gg, Gg, Gg, Gg, Gg, Gg, Gg, Gg, Gg, Gg, Gg, Re, Gg, Gg, Gg, Gg, Gg, Hh, Gg, Gg, Gg, Gg, Gg, Gs, Gs, Gs, Gs, Hh, Hh, Hh
Gs^Fds, Gs^Fds, Gs^Fds, Gs^Fds, Gs^Fms, Gs^Fms, Gs^Fds, Gs^Fds, Gs^Fms, Gs^Fds, Gs^Fds, Gg, Ww, Ww, Gg, Gg, Gs^Fms, Gs^Fds, Gs^Fms, Gs^Fds, Gg, Gg, Gg, Gg, Gg, Gg, Gg, Gg, Gg, Gg, Gs, Gg, Gg, Re, Gg, Gg, Gg, Gg, Hh, Hh, Hh, Hh, Gd^Vh, Gg^Edt, Gs, Gs, Gs^Es, Gs, Hh, Gs^Es, Hh, Hh, Hh
Gs^Fds, Gs^Fds, Gs^Fds, Gs^Fms, Gs^Fms, Gll^Fp, Gs^Fds, Gs^Fds, Gg^Ve, Gs^Fds, Gg^Em, Gg, Ww, Gg, Gg, Gs^Vl, Gs^Fds, Gs^Fds, Gs^Fds, Gg, Gg, Gg, Gs^Fds, Gg, Gs^Fms, Gg, Gg, Gg, Gg, Gs, Re^Es, Ch, Rp, Re, Gg, Gg, Gg, Gs, Hh, Hh, Hh, Gs^Edt, Re, Gg, Gs^Edt, Hh, Hh, Hh, Mm, Hh, Hhd, Hh, Hh
Gs^Fms, Gs^Fds, Gs^Fds, Gg^Ve, Gs^Fms, Gll^Fp, Gs^Fds, Gs^Fds, Gs^Fds, Gs^Fds, Gs^Fms, Gg, Gg, Ww, Ww, Gs^Fds, Gg, Gs^Fds, Gg, Gg, Gg, Gll^Fp, Gs^Fds, Gs^Fds, Gg, Gg, Gg, Gg, Gs, Gs^Es, Gs, Rp, Rp, Ch, Gs^Es, Gg, Gg, Gg, Gs, Gs, Gg, Gg, Re, Gs^Edt, Hh, Hh, Gs^Es, Hhd, Hhd, Gd^Dr, Gd^Dr, Hhd, Gs
Gs^Fds, Gs^Fms, Gs^Fds, Gs^Fms, Gs^Fds, 4 Ke, Ce^Ecf, Gs^Fms, Gs^Fms, Gs^Fds, Gg, Gg, Gg, Gg, Ww, Gg, Gg, Gs^Fms, Gg, Gg, Gg, Gg, Gg, Gg, Gg, Gg, Gs^Fds, Gg, Gg, Gs^Vl, Re, Re, Gs, Re^Es, Gg^Es, Gg, Gg, Gg, Gg, Gg, Gg, Gg, Gs, Re, Re, Gs, Gs, Hhd, Gs^Es, Gd^Dr, Gs^Es, Gs^Es, Gs^Es
Gs^Fms, Gs^Fds, Gs^Fms, Gs^Fms, Gs^Fds, Ce, Ce, Ce, Gg, Gs^Fms, Gg, Gg, Gg, Wwf, Gg, Gg, Gg, Gg, Gg, Gg, Gg, Gg, Gg, Gg, Gs^Fds, Gll^Fp, Gs^Fds, Gg, Gg, Gg, Re, Re, Gg, Gg, Gg, Gg, Gg, Gg, Gg, Gg, Gs, Gg, Hh, Gs, Hh, Re, Gs, Gs, Gs^Es, Gs^Es, Gd^Dr, Gs^Es, Hh
Gs^Fds, Gs^Fms, Gll^Fp, Gs^Fds, Gll^Fp, Gs^Fms, Gg, Gg, Gg, Gg, Gs^Fds, Gg^Em, Gs^Fds, Ww, Gg, Gg, Gs^Fds, Gs^Fds, Gs^Fds, Gs^Fds, Gg, Gg, Gg, Gg, Gg, Gs^Fms, Gg, Gg, Gg, Gg, Re^Edt, Gg, Gg, Gg, Gs, Gg, Gs, Hh, Hh, Hh, Hh, Hh, Hh, Hh, Gs, Re, Gs, Gs^Edt, Gs^Edt, Gd^Dr, Gd^Dr, Hhd, Hh
Gg, Gg, Gg, Gg, Gg, Gg^Em, Gg, Gll^Fp, Gs^Fms, Gs^Fds, Gs^Fms, Gs^Fds, Ww, Ww, Gg, Gg, Gg, Gll^Fp, Re^Gvs, Gg^Eff, Gg^Eff, Gg, Gg, Gg, Gg, Gg, Gs^Fds, Gs^Fds, Re, Re^Edt, Rp^Edt, Gg, Gg, Gg, Hh, Gs, Hh, Hh, Hh, Hh, Hh, Hh, Hh, Gs^Es, Re, Re, Gs^Edt, Hhd^Vhh, Hhd, Hhd, Hhd, Hh, Mm
Gg, Gg, Gg, Gg, Gg, Gg, Gg, Gs^Fds, Gg, Gll^Fp, Gg, Gs^Fds, Ww, Gg, Gg^Eff, Gg^Eff, Re^Gvs, Re^Gvs, Re^Gvs, Re^Gvs, Gs^Fds, Gg, Re^Gvs, Gg^Eff, Gg^Eff, Gg, Gs^Fds, Re, Ch, 3 Ket, Ch, Rp, Gg, Gg, Gg, Hh, Gs, Hh, Gs, Hh, Gs, Hh, Re^Gvs, Gs, Re, Gs^Edt, Hh, Hh, Hh, Hhd, Hh, Mm, Hh
Gg, Gg, Gg, Gg, Gg, Gg, Gg, Gg, Gg, Gg, Gg, Gg, Ww, Gg, Gg, Gd^Vh, Re, Re^Gvs, Re^Gvs, Gs^Fds, Re^Gvs, Re^Gvs, Re^Gvs, Re^Gvs, Re^Gvs, Gg^Eff, Gg^Eff, Re^Edt, Rp^Edt, Ch, Rp^Es, Re^Es, Gs, Gg, Re^Gvs, Re^Gvs, Re^Gvs, Gs^Eff, Gs^Eff, Gs, Re^Gvs, Re^Gvs, Re^Gvs, Re^Gvs, Gs, Hh, Gs, Hh, Gs, Hh, Gg, Hh, Gg
Re, Re, Re, Re, Re, Re, Re, Re, Re, Re, Re, Re, Re, Ww, Ww^Bw/, Re, Re, Gs, Gs, Gs, Gs^Vh, Re^Gvs, Re^Gvs, Re^Gvs, Gg^Eff, Gg^Eff, Gg, Gg^Edt, Gs, Rp, Gs^Vh, Gs, Gs, Gs, Re^Gvs, Re^Gvs, 2 Re^Gvs, Re^Gvs, Re^Gvs, Gs, Gd^Vh, Re^Gvs, Re^Gvs, Re^Gvs, Gs^Eff, Gs, Gs, Gg, Gg, Gg, Gg, Gg, Gg
Gg, Gg, Gs, Gs, Gs, Gs, Gg, Gg, Gg, Gs, Gs^Vc, Gs, Gs, Re, Gs^Fds, Ww, Gg, Re, Re, Re, Re, Gs, Re, Gg^Eff, Re, Gg, Re, Gg, Re, Re, Re, Gs, Re, Gs, Re, Gs^Vh, Re, Re^Gvs, Gs, Gs, Gs, Re^Gvs, Gg, Gg^Eff, Gg, Gg, Gg, Gg, Co, Co, Co, Gg, Gg
Gs^Fds, Gg, Re^Gvs, Re^Gvs, Re^Gvs, Gs^Vh, Re^Gvs, Gg, Gs^Fds, Gg, Re^Gvs, Re^Gvs, Re^Gvs, Gs^Fds, Gs^Fds, Ww, Ww, Gg, Rp, Rp, Rp, Re, Gs, Re, Gg, Re, Gs, Re^Edt, Re^Edt, Re^Edt, Gs, Re, Gg, Re^Edt, Gg, Re, Gg, Re, Re, Re, Re, Re, Re, Re, Re, Re, Re, Gg, Co, 1 Ko, Co, Re, Re
Gs^Fds, Gs^Fds, Gs^Fds, Re^Gvs, Re^Gvs, Re^Gvs, Re^Gvs, Re^Gvs, Gg^Eff, Re^Gvs, Re^Gvs, Re^Gvs, Re^Gvs, Re^Gvs, Gs^Fds, Gs^Fds, Gg, Ww, Rp, Chr^Ebn, Rp, Re, Gs, Gs, Gg, Gg, Gs, Gs, Re^Gvs, Re, Re, Gs, Gg, Gg, Gg, Gg, Gg^Efm, Gg, Gg, Gg, Gg, Gg, Gg, Gs, Gs, Gs, Gg, Re, Re, Co, Re, Re, Gg
Gs^Fds, Gs^Fds, Gg, Gg^Eff, Gg^Eff, Re^Gvs, Gg^Eff, Gg^Eff, Gg, Gg^Eff, Gg^Eff, Re^Gvs, Gg^Eff, Gg^Eff, Gg, Gg, Gg, Ww, Gg, Rp, Re, Re, Re^Gvs, Gg, Gg^Eff, Gg, Re^Gvs, Gs^Vh, Re^Gvs, Re^Gvs, Re^Gvs, Re, Gs, Gs^Fds, Gg, Gg^Efm, Gg, Gg^Efm, Gg, Gs^Fds, Gs^Fms, Gs^Fms, Gs^Fds, Gg, Gg, Gg, Gg, Gg, Gg, Re, Gg, Gg, Gg
Gg, Gg, Gg, Gg, Gg, Gg^Eff, Gg, Gg, Gg, Gg, Gg, Gg, Gg, Gg, Gg, Gs^Fds, Gg, Wwf, Gg, Re, Re^Edt, Re^Gvs, Re^Gvs, Re^Gvs, Re^Gvs, Gg^Eff, Gg^Eff, Re^Gvs, Re^Gvs, Re^Gvs, Gg^Eff, Re, Gs, Gs, Gg^Eff, Gg, Gs^Vh, Gg^Edt, Gg, Gg, Gg, Gg^Em, Gg^Efm, Gg, Gg, Gg, Gg, Gg, Gg^Efm, Gg, Gg^Efm, Gg, Gg^Efm
Gg, Gg, Gg, Gg, Gg^Fms, Gg^Fms, Gg, Gg^Fms, Gg, Gg, Gg, Gg, Gg, Gg, Gs, Gs, Gs, Ww, Ww^Bw/r, Re, Gs^Vh, Re^Gvs, Re^Gvs, Re^Gvs, Re^Gvs, Re^Gvs, Gg, Gg^Eff, Gg, Gg^Eff, Gg, Re, Gg, Gg^Eff, Re^Gvs, Re^Gvs, Re^Gvs, Re^Gvs, Re^Gvs, Re^Gvs, Re^Gvs, Gg^Efm, Gg^Efm, Gg, Gs^Fds, Gg, Gg, Gg^Efm, Gg, Gg^Efm, Gg^Efm, Gg^Efm, Gg^Efm
Gg, Gg, Gg, Gg^Fms, Gg^Fms, Gg^Fms, Gg, Gg, Gg, Gg, Gg, Gg, Gg, Gg, Re, Re, Re, Re, Ww, Gg^Edt, Gg^Eff, Re^Gvs, Re^Gvs, Re^Gvs, Gg^Fms, Re^Gvs, Gg, Gg^Efm, Gg, Gg, Gs, Re, Rp, Re^Gvs, Re^Gvs, Re^Gvs, Re^Gvs, Re^Gvs, Re^Gvs, Re^Gvs, Gg^Eff, Gg, Gg, Gg^Em, Gs^Fds, Gs^Fds, Gg, Gg, Gg^Eff, Gg, Gg, Gg^Efm, Gg
Gll^Fms, Gg, Gg, Gg, Gg^Fms, Gg^Em, Gg, Gg, Ss^Fms, Ss^Ewl, Gll, Gg, Re, Re, Gs, Gs, Gs, Gs, Ww, Gg, Gs^Fms, Gg^Eff, Gg^Fms, Gg^Fds, Gg^Fms, Gg^Fms, Gg^Fds, Gg, Gg^Fms, Gg, Gg, Rp, Ch, Rp, Re^Gvs, Re^Gvs, Re^Gvs, Re^Gvs, Gg^Eff, Gg^Eff, Gs^Fds, Gg, Gs, Gs^Fds, Gs^Fms, Gs^Fms, Gs^Vh, Re^Gvs, Re^Gvs, Gg^Eff, Gg^Eff, Gg, Gg
Ss, Gll^Fms, Gg, Gg, Gg, Gg, Gg, Gg, Gll^Fms, Ss^Ewl, Gll, Gg, Re, Gg, Gg, Gg, Gg, Ww, Ss, Gll, Gs^Fms, Gs^Fms, Gg, Gg^Fms, Gg^Fms, Gg^Fms, Gg^Fds, Gg^Fds, Gg^Em, Gg, Gs^Fms, Rp, Rp, Rp, Re^Edt, Re^Edt, Re, Gg, Gs^Fds, Gs^Fds, Gs^Fms, Gs^Fds, Gs, Gs, Gs^Edt, Re^Gvs, Re^Gvs, Re^Gvs, Re^Gvs, Re^Gvs, Re^Gvs, Gg, Gg
Ss, Ss^Fms, Gg^Em, Gg, Gll, Gg, Gg^Vhs, Gg, Gll^Em, Gll^Em, Gg, Re, Gg, Gll, Ss^Fms, Gg, Gll, Ww, Ss, Ss, Ww, Ww, Ww, Ww, Gg^Fms, Re^Vct, Re, Re^Ecf, Re, Gs^Fds, Gs^Fds, Gg, Gs, Re, Gs, Gs^Fds, Gs^Fms, Re, Re^Edt, Re, Re, Re, Re, Gs^Edt, Re^Gvs, Re^Gvs, Re^Gvs, Re^Gvs, Re^Gvs, Re^Gvs, Re^Gvs, Gg, Gg
Gll, Gll^Em, Gg, Gll, Ss^Ewl, Ss^Ewl, Gll, Gg, Gg, Gg, Gg, Ss^Vhs, Gg, Gll^Em, Gll, Ss, Ww^Ewl, Ww, Ww, Ww, Wo, Ww, Ww, Gg^Fms, Gg^Fds, Gg^Fms, Gg^Fms, Re, Gg^Efm, Gg^Em, Gg, Gg, Re, Re, Gs, Gs^Fms, Gs^Fds, Gs^Fds, Re^Gvs, Gs^Vh, Re^Gvs, Re^Gvs, Re^Gvs, Re^Eff, Re^Eff, Re^Gvs, Re^Gvs, Re^Gvs, Re^Gvs, Re^Gvs, Gg^Eff, Gg, Gg
Gg, Gg, Gg, Gll, Ss, Ss^Fms, Gll^Fms, Gg, Gg, Gg^Em, Ss^Fms, Gg, Gg, Gg, Ss, Ww^Ewl, Ww^Ewl, Ww, Wo, Wo, Ww, Ww, Gll, Gg^Fms, Gg^Em, Gg, Gg, Gg, Gg, Gg, Re^Gvs, Re, Re^Gvs, Gs, Gs^Eff, Gg^Em, Re^Gvs, Re^Gvs, Re^Gvs, Re^Gvs, Re^Gvs, Re^Gvs, Re^Gvs, Re^Gvs, Gs^Edt, Re, Re, Re^Gvs, Gg, Gg^Eff, Gs^Fds, Gs^Fds, Gg
Gg, Gg, Gg, Gg, Gg^Em, Gg^Em, Gg, 5 Gg, Gg, Gg, Ss^Ewl, Ss^Ewl, Gg, Gll^Fms, Ss, Ww^Ewl, Ww, Wo, Ww, Wo, Ww, Gg, Ss, Gll, Gg, Gg, Gg, Gs, Gs, Re^Gvs, Re^Gvs, Re^Gvs, Re^Gvs, Re^Gvs, Re^Gvs, Gs^Eff, Gs^Eff, Re^Gvs, Re^Gvs, Re^Gvs, Re^Gvs, Re^Gvs, Re^Gvs, Re^Gvs, Gg^Edt, Gs^Edt, Gs, Re, Gg, Gs^Fds, Gs^Fms, Gs^Fms, Gs^Fds
Gg, Gg, Gll, Gg, Gll, Gll, Gll, Gg, Gll, Gg, Gg, Gg, Gll^Em, Gll, Ww, Ww, Gll, Ww, Gll, Gg, Gg, Ss, Ss, Gll, Gg, Gg^Efm, Gg, Gs, Re^Gvs, Re^Gvs, Re^Gvs, Re^Gvs, Re^Gvs, Re^Gvs, Re^Gvs, Re^Gvs, Re^Gvs, Gs, Gg, Re^Gvs, Gg, Re^Gvs, Gg^Eff, Gg^Eff, Gs^Fms, Gs, Gs, Re, Re, Gg^Em, Gs^Fds, Gs^Fms, Gs^Fms
Gg, Gll, Ss^Ewl, Gll, Ss^Ewl, Ss^Fms, Gll^Em, Gg^Vhs, Gll, Gg^Fms, Ss^Fms, Gll^Em, Ss^Ewl, Gll, Gg, Gg, Gll, Gll, Ss, Gll^Vhs, Gg, Gll, Gs^Fms, Gg, Gs^Fms, Gg, Gs, Gs, Re^Gvs, Re^Gvs, Re^Gvs, Re^Gvs, Gs^Edt, Gs^Vc, Gs^Edt, Re^Gvs, Gs^Fds, Gg, Gg, Gg, Gg, Gg, Gs^Fds, Gs^Fms, Gs^Fms, Gs^Fds, Gg^Efm, Gg^Efm, Re, Gg, Gg, Gs^Fds, Gg
Gg, Gll, Ss, Ss^Ewl, Ss, Ss, Gg, Gg^Em, Gg, Ss, Ss, Ss, Gg, Gll^Em, Gg, Gg, Gg, Gg, Ss, Ss, Ss, Gs^Fms, Gll^Fds, Gg^Fds, Gg, Gs^Fms, Gg, Gs, Gg, Re^Gvs, Gg, Gs, Gg, Gs^Edt, Gg, Gs, Gg, Gs^Fds, Gg, Gg^Efm, Gg, Gs^Fds, Gg, Gs^Fds, Gg, Gs^Fds, Gg, Gg^Efm, Gg, Re, Gg, Gg, Gg
