Gs^Fds, Gs^Fds, Gs^Fds, Gs^Fds, Gs^Fms, Gs^Fds, Gs^Fms, Gs^Fms, Gs^Fms, Gs^Fms, Gs^Fds, Gs^Fds, Gs^Qhhf, Ww, Gs^Fms, Gs^Fms, Gs^Fms, Gs^Fms, Hh^Fds, Hh, Hh, Gg, Hh, Hh, Hh, Gg, Hh, Hh, Hh, Gg, Gg, Gg, Gg, Re, Gg, Gg, Gs^Fds, Gs^Fds, Gg, Gg, Gs, Gg, Gs, Gg, Rd, Gg, Gs^_mh, Gs^Fds, Gs^Fds, Gs^Fds, Gs^Fds, Gg, Gg
Gs^Fds, Gs^Fds, Gs^Fds, Gs^Fds, Gs^Fds, Gs^Fms, Gs^Fms, Gs^Fms, Gs^Fms, Gs^Fms, Gs^Fds, Gs^Qhhf, Ww, Ww, Gs^Fms, Gs^Fms, Gg, Gs^Fms, Gs^Fds, Hh, Hh^Fds, Hh, Hh, Hh, Hh, Hh, Gs, Hh, Gs, Hh, Gg^Efm, Gg, Re, Re, Gg^Efm, Gs^Fds, Gs^Fds, Gs^Fds, Gg^Efm, Gg, Gs, Gs, Gg, Rd, Rd, Gg, Gg, Gs^Qhhf, Gg^Eff, Gg, Gs^Vc, Gg, Gs
Gs^Fds, Gs^Fds, Gs^Fds, Gg^Ve, Gs^Fds, Gs^Fms, Gs^Fms, Gs^Fds, Gg^Ve, Gs^Fds, Gs^Qhhf, Gs^Qhhf, Ww, Gs^Fds, Gg, Gs^Vc, Gg, Gs^Fds, Gs^Qhhf, Gs^Fds, Ww, Wwr, Hh, Hh, Hh, Hh, Hh, Gs, Gs, Gs, Gg^Efm, Gg, Re, Gg, Gg^Efm, Gg^Efm, Gg, Gg, Gg, Gg, Gg, Gg^Efm, Gg, Gg^Efm, Rd, Gs, Gg^Eff, Gg^Eff, Gd, Gd, Gg^Eff, Gg, Gs^Fds
Gs^Fds, Gs^Fds, Gs^Fds, Gs^Fds, Gs^Fds, Gs^Fds, Gs^Fms, Gs^Fms, Gs^Fds, Gs^Qhhf, Gs^Qhhf, Gs^Qhhf, Gs^Qhhf, Ww, Ww, Re, Ww, Gs^Qhhf, Ww, Hh^Fds, Ww, Hh, Hh, Hh, Gs, Hh, Rd, Gs, Rd, Gg, Gg, Re, Gg, Gg, Gg, Gg, Gg, Gg^Efm, Gg, Gg^Efm, Gg, Gg^Efm, Gg^Efm, Gg, Gg^Efm, Gs, Gs, Gg^Eff, Gg, Gg^Eff, Gg, Gs^Fds, Gs^Fds
Gs^Fds, Gs^Fds, Gs^Fds, Gs^Fds, Gs^Fds, 4 Ke, Ce, Gs^Fms, Gs^Fms, Gs^Qhhf, Gs^Qhhf, Gs^Fds, Gs^Qhhf, Gs^Qhhf, Ww, Ww^Bw|, Gg, Ww, Gg^Eff, Ww, Hh, Hh, Hh, Hh, Gs, Rd, Hh, Rd, Gg, Gg, Re, Re, Gg, Gg^Efm, Gg^Eff, Gg^Eff, Gg^Eff, Rd, Rd, Rd, Gg^Efm, Gg^Efm, Gg, Gg, Gs, Gg, Gs, Gg, Gg^Efm, Gg, Gg^Efm, Gg, Gg
Gs^Fds, Gs^Fds, Gg^Ve, Gs^Fds, Gs^Fds, Ce, Ce, Ce, Gs^Fds, Gs^Qhhf, Gs^Fds, Gs^Qhhf, Ww^Ewl, Ww, Gg, Re, Gg^Eff, Gg^Eff, Gd, Gg^Eff, Gg^Eff, Gg, Gg, Hh, Gs, Gs, Hh, Gg, Gg, Re, Hh, Re, Re, Gg^Eff, Re^Gvs, Re^Gvs, Re^Gvs, Gg^Eff, Gg^Eff, Gs, Gs, Gs, Gg^Efm, Gg, Gg, Gs, Gg, Gs, Gs, Gg, Gg^Efm, Gg^Efm, Gg
Gs^Fds, Gs^Fds, Gs^Fds, Gs^Fds, Gs^Fms, Gs^Fds, Gs, Gs^Fds, Gs^Fds, Gs^Fds, Gs^Fds, Gs^Qhhf, Gs^Qhhf, Ww, Gg, Re^Eff, Re^Eff, Gd, Gs^Vc, Gg^Eff, Gg, Gg, Gg, Gg, Gg, Gs, Gg, Hh, Gg, Re, Hh^Fds, Hh, Re^Gvs, Re, Re, Gs^Vh, Re^Gvs, Re^Gvs, Gg^Eff, Gg^Eff, Gs^Efm, Gg, Gg, Gg, Gg^Eff, Gg^Eff, Gg^Eff, Gs, Gg, Gg, Gg, Gg, Gg
Gs^Fds, Gs^Fds, Gs^Fms, Gs^Fds, Gs^Fms, Gs^Fds, Gs, Gs^Fds, Gs^Fds, Gs^Fds, Gs^Fds, Gs^Qhhf, Ww, Ww, Gs^Fds, Gs^Fds, Gg, Re^Eff, Re, Re, Re, Re, Re, Re, Re, Gg, Gs^Vh, Gg, Ce, Ce, Ce, Hh^Fds, Re^Gvs, Re^Gvs, Gs^Vh, Re, Gs^Wm, Gg^Eff, Gg, Gg, Gg, Gg, Gg, Gg^Eff, Gg^Eff, Gs^Vc, Gd, Gg^Eff, Gg^Eff, Gg, Gs^Qhhf, Gg, Gs^Fds
Gs^Fds, Gs^Fds, Gs^Fds, Gs^Fms, Gs^Fds, Gs^Fds, Gs, Gs^Fds, Gs^Fds, Gs^Fds, Gs^Fds, Gs^Qhhf, Ww, Gs^Qhhf, Gs^Qhhf, Gs^Fds, Gs^Fds, Gg, Gs, Gs, Gg, Gg, Gg, Gg, Gg, Re, Re, Re, Ce, 3 Ket, Ce, Hh, Hh^Fds, Re^Gvs, Re, Re, Rd, Gg, Hh, Hh, Gs^Fms, Gs^Qhhf, Gg, Gg, Gs, Gg, Gg, Gg^Eff, Gg, Gs^Qhhf, Gs^Fms, Gg, Gs^Fms
Gs^Fds, Gs^Fds, Gs^Qhhf, Gs^Fds, Gs^Fms, Gs^Fds, Gs^Fms, Gs, Gs, Gs^Fds, Gg^Qhh, Gg^Qhh, Gg^Qhh, Ww, Gs^Qhhf, Gs^Fds, Gs^Fds, Gg, Gs, Gs, Rd, Rd, Rd, Gg, Hh, Gg, Hh, Hh, Gs^Fds, Ce, Hh, Hh^Fds, Hh, Hh, Rd, Re, Re, Rd, Gg, Hh, Hh^Fds, Gs^Fds, Rd, Gs, Gs^Efm, Gs^Efm, Gs, Gs, Hh, Hh, Hh^Fds, Gs^Fds, Hh^Fds
Gs^Fds, Gs^Fds, Gg, Gs^Qhhf, Gs^Qhhf, Gs^Fms, Gs^Fds, Gs^Fds, Gs, Gs^Fds, Gg, Gs^Fms, Gs^Qhhf, Ww, Ww, Ww^Ewl, Gs^Fds, Gs^Fds, Gs, Gs, Gg, Rd, Gg, Hh, Gg, Hh, Hh, Hh, Gs^Fms, Re, Re, Gs^Fds, Hh, Rd, Rd, Gg, 2 Gg, Re, Gs^Vc, Hh, Hh, Hh, Hh, Rd, Gs, Rd, Rd^Es, Rd, Hh, Hh, Hh, Hh, Hh
Gg, Gs^Fds, Gg, Gg, Gg, Gs^Qhhf, Gs^Qhhf, Gs^Qhhf, Gs^Fds, Gg, Gs^Vc, Gs^Fds, Gs^Fds, Gs^Fds, Gs^Qhhf, Ww, Gg, Gg, Gg, Gg, Gg, Gg, Gg, Gg, Gg, Gg, Gs^Fds, Gs^Fds, Gs^Fms, Gg, Re, Gg, Gg, Gg, Gg, Gg, Gg, Re, Rd, Rd, Rd, Rd, Rd, Rd, Rd, Rd^Es, Rd^Es, Rd, Co, Co, Co, Hh, Hh
Rr, Rr, Rr, Rr, Rr, Rr, Rr, Rr, Rr, Rr, Rr, Rr, Rr, Rr, Rr, Ww, Ww^Bw/, Rr, Rr, Rr, Rr, Rr, Rr, Rr, Rr, Rr, Rr, Rr, Rr, Rr, Rr, Rr, Rr, Rr, Rr, Rr, Rr, Rr, Rr, Rr, Rr, Rr, Rr, Rr, Rr, Rr, Rr, Rr, Co, 1 Ko, Co, Rr, Rr
Gg, Gg, Gg, Gg, Gg, Gg, Gg, Rd, Rd, Rd, Rd, Gg, Gg, Gg, Gs^Fds, Rr, Gg, Ww, Gg, Gg, Gg, Gg, Gg^Eff, Gg^Eff, Re^Eff, Gg, Gg^Eff, Gs, Re, Gs, Gg^Eff, Gg, Gg, Gg, Gg^Eff, Gg^Eff, Gg^Eff, Gg, Gg, Gg, Gs, Gg, Rd, Rd, Rd, Rd, Gg, Gg, Gg, Co, Gg, Gg, Gg
Gg, Gg, Gg, Gg^Efm, Gs, Gs^Efm, Gs, Gs, Rd, Rd, Gg, Gs^Fds, Gs^Qhhf, Gs^Qhhf, Gg, Gg, Gg, Ww, Gg, Gg, Gg^Eff, Gg^Eff, Re^Gvs, Re^Gvs, Rb^Gvs, Re^Eff, Re^Gvs, Gs^Vh, Re, Re^Gvs, Rb^Gvs, Gg^Eff, Gg, Gg^Eff, Re^Gvs, Rb^Gvs, Rb^Gvs, Gs^Eff, Gs^Eff, Gg, Gs, Rd, Ds, Rd, Ds, Rd, Rd, Gg, Gg^Efm, Gg, Gs^Fms, Gg, Gs^Fds
Gg, Gg, Gs^Efm, Gs, Gs, Gs, Gs, Rd, Gg, Gg, Gs^Fds, Gg, Gg, Gs^Fds, Gg, Gs^Fds, Gg, Ww, Gg, Gg, Re, Gg^Eff, Gg, Re^Gvs, Rb^Gvs, Rb^Gvs, Re^Eff, Re, Rb^Wm, Rb^Gvs, Re^Gvs, Re^Gvs, Re^Gvs, Re^Gvs, Re^Gvs, Rb^Gvs, Gs^Vh, Rb^Gvs, Re^Gvs, Gs^Eff, Gs^Eff, Rd, Ds, Ds, Ds, Ds, Gg, Gg, Gs, Gs, Gg^Efm, Gs^Fds, Gs^Fds
Gg, Gs^Efm, Gg^Efm, Gg, Rd, Gs, Gs, Gs^Efm, Gs^Efm, Gg, Gs^Fds, Gs^Fds, Gg^Efm, Gg^Efm, Gg, Gs, Gs, Ww, Wwf, Re, Gs^Vc, Re, Re, Re, Re, Re^Eff, Gll, Re, Re, Rb^Gvs, Re, Re^Gvs, Re, Re, Re, Re, Re, Re^Gvs, Gg^Eff, Gg^Eff, Gg, Ds, Ds, Ds, Ds, Ds, Gg, Gg, Gs, Gs^Efm, Gs^Qhhf, Gs^Fds, Gs^Fds
Gg, Gg, Gg, Gg, Rd, Rd, Rd, Gs, Gg, Gg, Gg^Efm, Gg, Gg, Gg^Efm, Re, Re, Re, Re, Ww, Gll, Gs^Fms, Gll, Gs^Fms, Gll^Fp, Gll^Fp, Gs^Fms, Gs^Fms, Gs^Fms, Gs^Fds, Re, Gll^Fp, Re, Re^Gvs, Re^Gvs, Re^Gvs, Re^Gvs, Re, Gg, Gs, Gg, Ds, Ds, Ds, Ds, Gg, Gg, Gg, Gg^Efm, Gg, Gs, Gs, Gs^Qhhf, Gg
Gg, Gg, Gs, Gs, Gg, Gg, Gg^Eff, Gg, Gg, Gg, Gg, Gg, Re, Re, Gs, Gs, Ds, Ds, Ww, Gll^Fp, Gll^Fp, Gs^Fms, Gll^Fp, Gll^Fp, Gll^Fp, Gll^Fp, Gll^Fp, Gll^Fp, Gs^Fms, Gll^Fp, Gll^Qhuf, Gll^Fp, Gs^Fms, Re^Gvs, Re^Gvs, Re^Gvs, Re, Gg, Gs^Wm, Gs, Gs, Gs, Ds, Rd, Rd, Gg, Gs^Vh, Gg^Eff, Gg^Eff, Gg, Gg, Gg, Gg
Gs, Gs, Gs, Gg, Gg^Eff, Gg^Eff, Re^Gvs, Gg^Eff, Gll^Eff, Gg^Efm, Gg, Gg, Re, Gg, Gs, Ds, Ds, Ww, Ww, Gll^Fp, Gll^Fp, Gll^Fp, Gll^Fp, Gll^Fp, Gll^Fp, Gll^Fp, Gll^Fp, Gll^Fp, Gll^Fp, Gll^Qhuf, Gll^Qhuf, Gs^Fms, Gs^Fms, Rb^Gvs, Rb^Gvs, Rb^Gvs, Re^Gvs, Re, Re, Gs, Gg^Efm, Gs, Rd, Rd, Re, Re, Re^Gvs, Re^Gvs, Re^Gvs, Gg^Eff, Gg^Eff, Gg, Gg
Gg, Gg, Gg^Eff, Gg^Eff, Re^Gvs, Re^Gvs, Gs^Vh, Gg, Gg, Gg, Re, Re, Re^Gvs, Gg^Eff, Gg^Eff, Gg, Ds, Ww, Wo, Ww, Ww, Ww, Ww, Ww^Ewl, Gll^Fp, Gll^Fp, Gll^Em, Re^Ecf, Gll^Em, Gll^Fp, Gll^Qhuf, Gs^Fds, Gs^Fms, Re^Gvs, Re^Gvs, Rb^Gvs, Rb^Gvs, Re^Gvs, Re, Gg, Gg, Gg, Gg, Gg, Re, Re^Gvs, Rb^Gvs, Rb^Gvs, Rb^Gvs, Re^Gvs, Gg^Eff, Gg^Eff, Gs
Gll^Eff, Gg^Eff, Re^Gvs, Re^Gvs, Re^Gvs, Re^Gvs, Re, Re, Re, Re, Re^Gvs, Gs^Vh, Re^Gvs, Re^Gvs, Gg^Eff, Gg^Eff, Ww, Ww, Wo, Ww, Wo, Ww, Ww, Gll^Fp, Gll^Qhuf, Gll^Qhuf, Gll^Fp, Gll^Em, Gll^Fp, Gll^Fp, Gll^Qhuf, Gll^Fp, Gll^Fp, Re^Gvs, Rb^Gvs, Rb^Gvs, Re^Gvs, Rb^Gvs, Re, Gs^Vh, Re, Re, Re, Re, Gg^Wm, Gg^Eff, Gg^Eff, Rb^Gvs, Gg^Eff, Gg^Eff, Gg^Efm, Gs, Gs
Gg, Gg^Eff, Gg^Eff, Re^Gvs, Re^Gvs, Re^Gvs, Re, Ch, Re, Re^Gvs, Re^Gvs, Re^Gvs, Gg^Eff, Gg^Eff, Gg, Ww^Ewl, Ww, Ww, Wo, Wo, Ww, Ww, Gll^Fp, Gll^Fp, Gll^Qhuf, Gll^Fp, Gll^Fp, Gll^Fp, Gll^Fp, Gll^Fp, Gll^Fp, Gll^Fp, Gll, Gg, Gg, Re^Gvs, Re, Re, Re^Gvs, Re, Rb^Gvs, Re^Gvs, Re^Gvs, Gg^Eff, Gg^Eff, Gg, Gg, Gg^Eff, Gg^Efm, Gg, Gs, Gs, Gs
Gg, Gg, Gg, Gg^Eff, Gg^Eff, Re^Gvs, Gg, 5 Re, Gg, Gg^Eff, Gg^Eff, Gg^Eff, Gs, Gg, Ds, Ww, Ww, Wo, Ww, Wo, Ww, Gll^Fp, Gll, Gll^Fp, Gs^Qhuf, Gs^Fms, Gs^Fms, Gs^Fds, Gs^Fms, Gs^Fms, Gll, Gs^Fms, Gg, Gg, Gg, Gg, Re, Re^Gvs, Rb^Gvs, Rb^Gvs, Rb^Gvs, Rb^Gvs, Gg^Eff, Gg^Eff, Gs, Gg, Gg, Gg^Efm, Gg^Efm, Gs, Gg, Gg, Gs
Ds, Rd, Rd, Gg, Gg, Gg, Re, Re, Gs, Gs, Gs, Gs, Gg, Ds, Ww, Ww, Ww, Ww, Ww, Gll, Gll^Em, Ww^Ewl, Gll, Gll^Fp, Gs^Qhuf, Gs^Fms, Gll, Gs^Fms, Gg, Gs^Fms, Gg, Gg, Gg, Gg, Re, Re, Gg, Gg^Eff, Gg^Eff, Re^Gvs, Gg^Eff, Gg^Eff, Gs, Gs, Gg^Efm, Gg, Gg, Gg^Efm, Gg, Gg, Gs, Gg, Gg
Ds, Ds, Rd, Gs, Rd, Gg, Re, Gs^Vc, Gg, Gs, Gs, Gs, Ds, Ds, Ww, Gg, Gg, Gll, Gll^Em, Gll^Vhs, Gll^Emf, Gll^Em, Gs^Fms, Gll^Qhuf, Gs^Fms, Gs^Fds, Gll, Gg, Gg, Gg, Gg, Gg, Gg, Gs^Vc, Re, Gg, Gg, Gg, Gg, Gg^Eff, Gg, Gg^Efm, Gg, Gs^Efm, Gs, Gs, Gs, Gg^Efm, Gg, Gs, Ch, Ch, Ch
Ds, Ds, Ds, Ds, Gg, Gg, Re, Gg, Gs, Gs, Gg, Gg, Gg, Ds, Ww, Gg, Gg, Gg^_mh, Gg, Gll^Em, Gll, Gs^Fms, Gll^Fds, Gg^Fds, Gg, Gs^Fms, Gg, Gll, Gg, Gg, Gg, Gg, Gg, Re, Gg, Gg, Gg, Gs, Gs, Gs, Gs, Gs, Gs, Gs, Gg, Gs, Gg, Gg, Gg, Gs, Ch, Kh, Ch
