Hh, Hh, Hh, Hh, Mm, Hh, Mm, Mm, Mm, Hh, Hh, Hh, Hh, Hh, Ww^Es, Hh, Hh, Hh, Gll^Fp, Hh, Gll^Fp, Gll^Fp, Gll^Fp, Gll^Fp, Gll^Fp, Hh, Hh, Gg, Hh, Hh, Hh, Hh, Hh, Mm, Hhd, Hhd, Hhd, Mm, Mm
Hh, Hh, Mm, Mm, Mm, Mm, Mm, Mm, Mm, Hh, Hh^Vo, Hh, Mm, Ww^Es, Mm, Ww^Es, Hh, Hh, Gll^Fp, Gll^Fp, Gll^Vo, Gll^Fp, Gll^Fp, Gll^Fp, Mm, Hh, Mm, Hh, Hh^Fp, Hh, Mm, Hh, Hh, Mm, Mm, Hhd, Hhd, Mm, Mm
Mm, Hh, Hh, Mm, Hh, Hh, Hh, Hh, Hh, Hh, Hh, Hh, Mm, Mm, Ww^Es, Ww^Es, Mm, Mm, Mm, Gll^Fp, Gll^Fp, Gll^Fp, Mm, Gll^Fp, Mm, Mm, Mm, Hh, Hh^Fp, Mm, Mm, Mm, Hh^Fp, Mm, Mm, Mm, Wwr, Mm, Mm
Mm, Hh, Hh, Hh, Hh, Hh, Co, Hh, Re, Hh, Mm, Mm, Mm, Mm, Gll^Fp, Ww^Es, Ww^Es, Mm, Hh, Gll^Fp, Gd, Gll^Fp, Mm, Mm, Mm, Mm, Mm, Hh, Hh, Hh^Vo, Hh, Hh^Fp, Mm, Hh^Fp, Hh, Hh, Ww, Hhd, Hhd
Mm, Mm, Hhd, Hhd, Hhd, Co, 2 Ko, Co, Re, Hh, Hh, Hh^Fp, Mm, Hh^Fp, Ss, Ss^Es, Ss^Es, Gll^Fp, Hh, Gd, Hh^Fp, Mm, Mm, Mm, Hh, Hh, Hh, Mm, Hh, Hh, Hh, Mm, Mm, Mm, Hh, Hh, Hh, Ww, Hhd
Mm, Hh, Hhd, Rb^Vo, Rb^Ecf, Co, Co, Co, Re, Hhd, Hhd, Mm, Hh, Hh, Re^Edb, Ss^Edb, Re^Edb, Hh, Re, Re, Hh^Fp, Hh^Fp, Mm, Hh, Hh, Hh, Hhd, Hhd, Hhd, Hh, Hh, Hh, Hh, Mm, Hh^Fp, Hh^Fp, Hh, Ww, Ww
Mm, Mm, Mm, Rb, Rb^Vo, Rb, Rb, Rb, Re^Edt, Re^Vo, Hhd^Edt, Mm, Hh, Re, Re^Edb, Co, Re^Edb, Re^Vo, Re^Edt, Hhd, Hh, Hh, Hh, Hh, Re, Re, Rb^Edt, Rb^Vo, Rb^Edt, Hh, Hh, Mm, Mm, Hh, Hh, Hh^Fp, Hh, Hh, Ww
Mm, Mm, Hh, Hhd, Hhd, Hhd, Hh, Hh, Hh, Re^Edt, Hh, Hh, Hh, Gd, Ss, Ss^Edb, Ss, Re^Edt, Hhd, Hhd, Hh, Hh, Hhd, Re, Co, Co, Co, Rb^Ecf, Hhd^Vo, Hhd, Mm, Mm, Mm, Wwr, Hh, Hh^Vo, Hh, Ww, Ww
Mm, Mm, Mm, Hh^Fp, Hh^Fp, Hh, Hh, Hh^Fp, Hh, Re, Re^Es, Hh, Hh, Re^Es, Gll^Fp, Ss, Hh, Hh, Hh, Hh, Re, Hhd, Re^Vo, Re^Edt, Co, 1 Ko, Co, Rb^Edt, Hhd^Edt, Hhd, Hh, Mm, Hh, Ww^Es, Ww^Bp/, Hh, Ww, Ww, Wo
Mm, Hh^Fp, Mm, Hh^Fp, Hh, Hhd, Re^Vo, Hhd, Hh, Hh, Hh, Re^Es, Gd, Re, Re^Es, Re^Es, Re^Es, Hh, Hh, Hh, Re, Re^Edt, Hhd^Edt, Re^Edt, Re^Edt, Co, Rb, Rb, Re^Es, Hh, Hh, Mm, Hh, Hh, Ww^Es, Ss, Ww, Ww, Wo
Mm, Hh^Fp, Hh^Fp, Hh, Re^Es, Re^Edt, Re^Edt, Hhd, Re, Hh, Re^Es, Gd, Gd, Hh, Hh, Hh, Re, Hh, Hh, Hh^Es, Gd, Hhd, Hhd, Hhd, Re^Dr, Re^Edt, Hh^Dr, Hh, Hh, Re^Es, Hh, Hh, Hh, Ss, Ss, Ww, Ww, Wo, Wo
Hh, Hh^Fp, Hh^Fp, Hh, Re^Es, Hh, Hh, Re, Hh, Re, Re^Edt, Hhd^Vo, Hhd^Edt, Hh, Hh, Hh, Hhd, Re^Es, Gd, Gd, Hh, Re, Hh, Hh, Hh^Dr, Hh^Dr, Hh^Dr, Hh, Hh, Re^Es, Re, Hh, Hh, Ss, Ss, Ww, Ww, Wo, Ww
Hh, Hh, Hh, Hh, Hh, Hh, Hh, Re, Hh, Hh, Hh, Hhd^Edt, Re, Hh, Hh, Hhd, Re, Re^Edt, Re, Gd, Hh, Hh, Hh, Hh^Dr, Hh, Hh^Dr, Hh, Hh^Vo, Hh, Hh, Hhd, Re^Edt, Re^Vo, Hh, Hh, Ww^Es, Ww^Es, Wo, Ww
Hh, Hh, Gs, Hh^Fp, Hh, Hh, Gs, Re, Hh, Hh^Fp, Hh, Re^Es, Hh, Re, Hh, Hhd, Re^Edt, Re^Vo, Re, Hh, Hh, Hh^Edt, Hhd^Vo, Hh^Edt, Wwrg, Hh, Ww^Es, Hh, Ww, Hh, Hhd, Re, Re^Edt, Hh, Hh, Hh, Ww^Es, Wo, Ww
Gg, Gs, Gs, Hh, Hh, Hh, Gs, Hh, Hh^Fp, Hh^Fp, Hhd^Vo, Re, Hhd, Hhd, Hhd, Hh, Re, Re, Hh, Re, Re^Es, Hhd, Hhd, Hhd^Edt, Ss, Ww^Es, Ss, Ww^Es, Hh, Ww^Es, Ww, Co, Re, Co, Ss, Hh, Ww, Wo, Ww
Gg, Gs, Gg, Hh, Gs, Gs, Hh, Hh, Hh, Hhd, Hhd^Edt, Hhd^Edt, Hhd, Co, Hhd, Re^Es, Gd, Hh, Hh, Hh, Re, Gd^Fp, Gd^Fp, Hh^Fp, Ss, Ss^Ewl, Ss, Hh, Hh, Hh, Ww, Ss, Re^Edt, Ss, Ss, Ss, Ww, Wo, Ww
Gg, Gg, Gg, Gg, Gg, Gs, Hh, Hh, Gs, Hh, Hh, Hh, Gd, Co, Re, Re, Hh, Gd, Hh, Hh, Gd^Fp, Re^Dr, Hh, Hh, Hh, Ss, Hhd, Hhd, Hhd, Hh, Ww^Bp/, Re^Es, Hhd^Vo, Hhd, Hhd, Ww^Es, Ww, Wo, Ww
Gg, Gg, Gs^Eff, Gg, Gg, Gg, Gg, Gs, Hh, Hh, Re^Es, Re, Hh, Re, Co, Hhd, Hhd, Re, Hh, Hh, Hh^Fp, Hh, Hh, Hh, Gd^Fp, Gd^Fp, Hh, Hh, Re^Vo, Re^Es, Ss, Ww, Hh, Hhd, Hh, Ww, Wo, Wo, Gs
Gs, Gs^Eff, Re^Gvs, Gs^Eff, Gg, Gg, Gg, Gs, Gs, Hh, Re, Hh, Hh, Hhd, Hhd, Co, Hhd, Hh, Hhd^Vo, Hh, Hh, Hh, Gd^Fp, Re, Re, Gd^Fp, Gd^Fp, Hh, Re, Re, Re, Ww^Ewl, Ww^Es, Hh, Hh, Ww, Wo, Ww, Gs
Gs, Re^Gvs, Re^Gvs, Re^Gvs, Re^Gvs, Re^Gvs, Gg, Gg, Gg, Re^Dr, Gg, Gs, Gs, Gs, Hh, Hhd, Hh^Fp, Hhd, Hhd, Hhd, Hh, Hh, Hh^Fp, Gd^Fp, Re, Gd^Fp, Re^Dr, Hhd, Re^Vo, Re^Edt, Ss, Ss, Ww, Hh, Ww, Ww, Wo, Ww, Gs
Re^Gvs, Re^Gvs, Re^Gvs, Gd^Vhr, Re^Gvs, Re^Gvs, Gg, Gg, Re, Re, Gg, Gs, Gs, Gs, Gs^Fp, Hh, Gs^Fp, Hh, Gs^Fp, Hh, Re, Re, Re, Re, Hh, Re, Hhd, Re^Ecf, Re^Edt, Re^Edt, Co, Ss, Ss, Ww, Ww, Wo, Ww, Ww, Gll^Fp
Gs^Eff, Re^Gvs, Re^Gvs, Re^Gvs, Re^Gvs, Re^Gvs, Gg, Gg, Re, Gg, Re^Gvs, Re^Gvs, Re^Gvs, Re^Gvs, Gll^Fp, Gs^Fp, Gs^Fp, Gs^Fp, Gs^Fp, Re, Hh, Hh, Gs^Fp, Hh, Hh^Fp, Hh, Re, Re^Vo, Rb, Co, 3 Ko, Co, Re, Ww, Ww, Wo, Ww, Ww, Gll^Fp
Gg, Gs^Eff, Gs^Eff, Re^Gvs, Gg^Edb, Gg, Re, Re^Edb, Gg, Gg, Gg, Re^Gvs, Gs^Eff, Gll^Fp, Gll^Fms, Gll^Fp, Re^Gvs, Gll^Fp, Re, Re, Hh, Hh^Fp, Gs^Fp, Gs^Fms, Gs^Fp, Hh^Fp, Hhd, Re^Edt, Rb^Edt, Co, Co, Co, Re, Ww^Bw\, Wo, Wo, Ww, Gll^Fp, Gll^Fp
Gg, Gg, Gg, Gs, Gg, Gg, Re, Re, Gg, Gg, Gs^Eff, Gs^Eff, Re^Gvs, Gs^Eff, Gg, Re^Gvs, Re^Gvs, Gll^Fp, Re, Gs^Fp, Gs^Fp, Gs^Fp, Gll^Fp, Gll^Fp, Gll^Fp, Gs^Fp, Gs^Fms, Gs^Fp, Rb^Vo, Rb^Edt, Rb^Edt, Re, Ww^Bw\, Ww^Bw\, Wo, Ww, Gs, Gs, Gll^Fp
Gg, Gg, Gg, Gg, Rp^Edb, Rp^Edb, Rp^Edb, Gg, Gg, Re, Re^Gvs, Re^Gvs, Re^Gvs, Re^Gvs, Gg, Gg, Re, Re, Gg, Gll^Fp, Gll^Fp, Gll^Fp, Gll^Fp, Gll^Fp, Gll^Fp, Gll^Fp, Gll^Fp, Gll^Fp, Gll^Fp, Rb^Edt, Hhd, Hhd, Ww, Wo, Ww, Ww, Gs, Gll^Fms, Gll^Fp
Gg, Gg, Gg, Gg, Rp^Edb, 4 Chr, Rp^Edb, Gg, Gg, Re^Gvs, Re^Gvs, Gd^Vhr, Re^Gvs, Re^Gvs, Re, Re^Edb, Re^Edb, Gg, Re^Gvs, Re^Gvs, Re^Gvs, Re^Gvs, Gg^Eff, Gll^Fp, Gll^Fp, Gll^Fp, Gll^Fp, Gll^Fp, Gll^Fp, Gs^Fp, Ww^Es, Ww^Es, Wo, Wo, Ww, Gll^Fp, Gll^Fms, Gll^Fp, Gll^Fp
Gg, Gg, Gg, Gg, Re, Rp^Edb, Gg, Gg, Gg, Re^Gvs, Gg, Re^Gvs, Gs^Eff, Gs^Eff, Gg, Gg, Re, Re^Gvs, Re^Gvs, Re^Gvs, Gd^Vhr, Re^Gvs, Re^Gvs, Gg^Eff, Gg^Eff, Gll^Fp, Gll^Fp, Gll^Fp, Gll^Fp, Gll^Fp, Ww^Es, Ww, Wo, Ww, Gs, Gll^Fp, Gll^Fms, Gll^Fms, Gll^Fp
Gg, Gg, Re, Re, Gg, Gg, Re^Gvs, Gg, Gg, Gg^Edb, Gg, Gs, Re^Gvs, Re^Gvs, Gg, Gg, Gg, Re^Gvs, Gg, Gg, Re^Gvs, Re^Gvs, Gg^Eff, Gg^Eff, Gll^Fp, Gll^Fp, Gll^Fp, Gll^Fp, Ww, Ww, Wo, Wo, Ww, Gll^Fp, Gll^Fp, Gll^Fp, Gll^Fp, Gll^Fp, Gll^Fp
Re, Re, Gg, Gg, Gg, Re^Gvs, Re, Gg, Gg, Gg, Gg, Re^Gvs, Re^Gvs, Re^Gvs, Gg, Gg, Gg, Gg, Gg, Gg, Re, Gs, Gll^Fp, Gll^Fp, Gg, Gll^Fp, Gg, Ww, Ww, Wo, Ww, Ww, Gll^Fp, Gll^Fp, Gll^Fp, Gll^Fms, Gll^Fp, Gll^Fp, Gll^Fp
