Gs^Fms, Gs^Fms, Gs^Fds, Gs^Fds, Gs^Fds, Gs^Fds, Gs^Fds, Gs^Fds, Gs^Fds, Gs^Fds, Gs^Fms, Gs^Fms, Gs^Fds, Ww, Gs^Fds, Gs^Fms, Gs^Fms, Gs^Fds, Gs^Fds, Gs^Fds, Gs^Fds, Gs^Fds, Gs^Fds, Gs^Fms, Gg, Gg, Gg, Gg, Gg^Efm, Gg, Gg, Gg, Gg, Gs, Gg, Re, Gg, Gg, Gg^Efm, Gg^Efm, Gg, Gg, Gg, Gg, Gg^Efm, Gg, Gg, Gg, Gs^Eff, Gg, Gg, Gg, Gg
Gs^Fms, Gs^Fms, Gs^Fms, Gs^Fds, Gs^Fms, Gs^Fds, Gs^Fds, Gs^Fds, Gs^Fds, Gs^Fms, Gs^Fms, Gs^Fms, Gs^Fds, Ww, Ww, Gs^Fms, Gs^Fms, Gs^Fds, Gs^Fds, Gs^Fds, Gs^Fms, Gs^Fms, Gs^Fms, Gs^Fms, Gg, Gg, Gg^Efm, Gg^Efm, Gg^Efm, Gg^Efm, Gg, Gg, Gg, Gg, Re, Re, Gg, Gg^Efm, Gg, Gg^Efm, Gg^Efm, Gg, Gg^Efm, Gg^Efm, Gg, Gg, Gs, Gs^Eff, Gd^Vc, Gs^Eff, Gs^Eff, Gg, Gg
Gll^Fp, Gll^Fp, Gs^Fms, Gs^Fms, Gs^Fds, Gs^Fds, Gs^Fds, Gs^Fds, Gs^Fms, Gll^Fp, Gll^Fp, Gs^Fms, Gs^Fms, Gs^Fds, Gs^Fds, Ww, Gs^Fds, Gs^Fms, Gs^Fds, Gll^Fp, Gs^Fms, Gs^Fms, Gs^Fds, Gs^Fds, Gg, Gg, Gg, Gg^Efm, Gg^Efm, Gg, Gs, Gs^Vc, Gs, Gg, Re, Gg, Gs, Gs, Gs, Gs, Gs, Gg, Gg^Efm, Gg^Efm, Gg^Efm, Gg, Gs, Gd, Gs, Gs^Eff, Hh, Hh, Hh
Gll^Fp, Gs^Fms, Gs^Fms, Gs^Fms, Gs^Fds, Gs^Fds, Gs^Fds, Gs^Fds, Gs^Fms, Gll^Fp, Gs^Fds, Gs^Fms, Gs^Fds, Gs^Fms, Gs^Fds, Ww, Ww, Gs^Fds, Gs^Fds, Gll^Fp, Gs^Fds, Gs^Fms, Gs^Fms, Gll, Gll, Gll, Gll^Fp, Gg, Gg, Gg, Gg, Gs, Re, Re, Gg^Efm, Gg, Gs, Gd^Vc, Rd, Rd, Gs, Gg, Gg^Efm, Gg, Gg, Gg, Gg, Gg, Gg, Gg, Hh, Hh, Hh
Gs^Fms, Gs^Fds, Gs^Fds, Gs^Fms, Gs^Fds, 4 Ke, Ce, Gs^Fds, Gs^Fds, Gs^Fms, Gs^Fds, Gs^Fds, Gs^Efm, Gs^Fms, Ww, Ww, Gs^Fds, Gs^Fds, Gs^Fms, Gs^Fds, Gs^Fds, Gs^Fds, Gs^Fds, Gll, Gs^Fms, Gs^Fds, Gs^Fms, Gs^Fms, Gg, Gg^Efm, Gg, Gg, Re, Gg^Efm, Gg, Gg, Gg, Gs, Rd, Rd, Gg, Gg, Gg, Gg, Gs, Gg, Gs^Fds, Gs^Fds, Hh^Fds, Hh, Hh, Hh, Gg
Gs^Fms, Gs^Fds, Gs^Fds, Gs^Fds, Gs^Fds, Ce, Ce, Gs^Fds, Gs^Fds, Gs^Fms, Gs^Fds, Gs^Efm, Gs^Efm, Ww, Gs^Fms, Ww, Gs^Fms, Gs^Fms, Gs^Fms, Gs^Fms, Gs^Fds, Gs^Vl, Gll, Gll, Gll^Fp, Gll^Fp, Gs^Fms, Gll^Fp, Gg, Gg, Re, Re, Gg, Gg, Gs^Fds, Gg, Gs^Fds, Rd, Gg, Gg^Efm, Gg^Efm, Gg^Efm, Gg, Gg, Gs^Eff, Gs^Eff, Gs^Eff, Gs^Fds, Rd, Rd, Hh, Gg, Gg
Gs^Fds, Gs^Fms, Gs^Fms, Gs^Fds, Gs^Fds, Gs, Gs^Ecf, Gs, Gs^Fds, Gs^Fms, Gs^Fms, Gs^Fds, Ww, Ww, Gs^Fms, Gs^Fds, Gs^Fms, Gs^Fms, Gll, Gs^Fms, Gll, Gll, Gll, Gll^Fp, Gs^Fms, Gs^Fds, Gll^Fp, Gll^Fp, Gg, Gg, Re, Re, Gs^Vh, Re^Gvs, Re^Gvs, Gs^Fds, Gs^Fms, Gg, Gg, Gg, Hh, Gg, Gg^Efm, Gs^Eff, Gs^Eff, Gd^Vc, Gd, Gs, Gg, Rd, Gg, Gg, Gg
Gs^Fds, Gs^Fds, Gs^Fds, Gs^Fds, Gs^Fds, Gs, Gs, Gs, Gs^Fds, Gs^Fds, Gs^Fds, Gs^Fds, Gs^Fds, Ww, Ww, Gs^Fms, Gs^Fds, Gg, Gg, Gll, Gll, Gll^Fp, Gll^Fp, Gll^Fp, Gll^Fp, Gs^Fds, Gg, Gg, Ce, Ce, Ce, Re^Gvs, Rb^Gvs, Rb^Gvs, Re^Gvs, Gs^Fms, Gs^Fds, Hh^Fds, Hh, Hh, Gg, Gg, Gg, Gg^Efm, Gs, Gs, Gs, Gg, Gg, Rd, Gg, Gg, Gg
Gs^Fms, Gs^Fms, Gs^Fms, Gs^Fds, Gs^Fds, Gs^Fds, Gs, Gs^Fds, Gs^Fds, Gs^Fds, Gs^Fms, Gs^Fms, Gs^Fds, Ww, Gs^Fms, Ww, Ds, Ds, Gg, Gg, Gg, Gg, Gs^Fms, Gs^Fms, Gs^Fms, Gg, Gg, Gg, Ce, 3 Kh, Ce, Re^Gvs, Re^Vh, Rb^Gvs, Rb^Gvs, Hh^Fds, Hh, Hh^Fds, Hh, Hh, Hh, Gg, Rd, Gg, Gg, Gg, Gg, Gg, Gg^Efm, Gg, Gg^Efm, Gg^Efm, Gg
Gs^Fds, Gs^Fms, Gs^Fms, Gs^Fms, Gs^Fms, Gs^Fds, Gs^Fds, Gs, Gs^Fds, Gs^Fds, Gs^Fms, Gs^Fms, Gs^Fms, Gs^Fms, Gs^Fms, Ww, Ds, Ds, Gg, Gg^Efm, Gg^Efm, Gll^Fp, Gg, Gs^Vc, Gg, Gg, Gs^Fms, Gg, Rp, Ce, Rr, Re^Gvs, Rb^Gvs, Rb^Gvs, Re^Gvs, Hh, Gs^Fds, Hh, Gs^Vc, Hh, Hh, Rd, Rd, Gg, Gg, Gg^Efm, Gg^Efm, Gg, Gg^Efm, Gg^Efm, Gg^Efm, Gg, Gg
Rp, Gs^Fms, Rp, Gs^Fds, Gs^Fds, Gs^Fds, Gs, Gs, Gs, Gs^Fds, Gs^Fds, Gs^Fds, Gs^Fds, Gs, Gs, Ww, Ww, Gg, Gg, Gg^Efm, Gg, Gg^Efm, Gg, Gg, Gg, Gs^Fms, Gg, Gg, Rr, Rr, Re, Rb^Gvs, Re^Gvs, Rb^Gvs, Gg, Gs^Fds, 2 Gg, Gg, Gg, Gg, Gg, Rd, Rp, Rd, Rr, Gg, Gg, Gg, Gg, Gg, Gg, Gg, Gg
Gg, Rp, Gg, Rr, Rr, Rp, Rr, Rr, Rr, Gs^Fds, Rp, Gs, Rp, Rr, Rr, Rr, Ww^Bw\, Gg, Rp, Gg, Rr, Gg, Rp, Rr, Rr, Rp, Rr, Rr, Rr, Re^Vh, Rr, Re, Rr, Gg, Rp, Gg, Rr, Rr, Rr, Rp, Rp, Rp, Gg, Rp, Gs, Rr, Rr, Rp, Rr, Rr, Rr, Rr, Rp
Gg, Gg, Gg, Gg, Gg, Gg, Gg, Gg, Gg, Rr, Gg, Rr, Gg, Gg, Gg, Ds, Ww, Rr, Gg, Rr, Gg, Rp, Gg^Eff, Gg^Eff, Gg^Eff, Gg, Gg, Gg, Gg, Rr, Gg, Rp, Gg, Rr, Gg, Rp, Gg, Gg, Re, Re, Gg^Eff, Gg, Gg, Gg^Efm, Gg^Efm, Gs, Gg, Gg, Co, Co, 1 Ko, Rd^Es, Rd^Es
Gg, Gg, Gg, Gg, Gg, Gg, Gg, Gg, Gg, Gg, Gg, Gg, Gg, Gg, Gg, Ds, Ww, Gg, Gg, Gg, Gg, Gg^Eff, Gg^Eff, Gd^Vc, Gs, Gg, Gg^Efm, Gg^Efm, Hh, Gg, Ds, Rd, Rd, Gg, Gg, Gg, Gs^Eff, Gg, Re, Gs^Vh, Rb^Gvs, Gg^Eff, Gg^Eff, Gg, Gg, Gs, Gs, Gg, Gg, Co, Rd^Es, Rd^Es, Rd^Es
Gg, Gg, Gg, Gg, Gg, Gg, Gg, Gg, Gg, Gg, Gg, Gg, Gg, Gg, Gg, Ds, Ds, Ww, Ww, Ww, Ww, Gg, Gg, Gg, Gs, Gs, Gg, Gg, Hh, Hh, Ds, Ds, Ds, Ds, Gs^Eff, Gs^Eff, Rb^Gvs, Re^Gvs, Re, Re^Gvs, Rb^Gvs, Re^Gvs, Re^Gvs, Gs^Eff, Gs^Eff, Hh, Hh, Gg, Hh, Rd^Es, Hh, Hh, Hh
Gg, Gg, Gg, Gg, Gg, Gg, Gg, Gg, Gg, Gg, Gg, Gg, Gg, Gg, Gg, Gg, Gg, Gg, Gg, Gg, Gg, Ww, Ww, Gg, Gg, Gs, Gg, Hh, Gg, Ds, Rd, Ds, Ds, Gg, Gg, Re^Gvs, Re, Re, Rb^Gvs, Gs^Eff, Gs^Eff, Rb^Gvs, Gs^Eff, Gs^Eff, Hh, Hh, Hh, Hh, Hh, Rd^Es, Hh, Hh, Hh
Gg, Gg, Gg, Gg, Gg, Gg, Gg, Gg, Gg, Gg, Gg, Gg, Gg, Gg, Gg, Gg, Gg, Gg, Gg, Gg, Gg, Gg, Ww, Ds, Ds, Gg, Gg, Gg^Efm, Gg^Efm, Gg, Rd, Rd, Gg, Ds, Re, Gs^Vh, Re, Re^Gvs, Rb^Gvs, Rb^Gvs, Rb^Gvs, Gs^Eff, Gg, Gg, Rd^Es, Rd^Es, Hh, Hh, Hh, Hh, Hh, Hh, Hh
Gg, Gg, Gg, Gg, Gg, Gg, Gg, Gg, Gg, Gg, Gg, Gg, Gg, Gg, Gg, Gg, Gg, Gg, Gg, Gg, Gg, Gg, Gg, Ww, Ds, Gg, Ds, Gg^Efm, Gg, Gg, Gg, Gg, Re, Re, Rb^Gvs, Re^Gvs, Rb^Gvs, Re, Re, Rb^Gvs, Gs^Vh, Re^Gvs, Re, Re, Re, Rd^Es, Rb^Gvs, Rb^Gvs, Re^Vh, Hh, Re^Gvs, Hh, Hh
Gg, Gg, Gg, Gg, Gg, Gg, Gg, Gg, Gg, Gg, Gg, Gg, Gg, Gg, Gg, Gg, Gg, Gg, Gg, Gg, Gg, Gg, Gg, Ww, Ww, Ds, Ww, Ds, Re, Re, Re, Re, Re, Re^Gvs, Rb^Gvs, Rb^Gvs, Re^Gvs, Re^Gvs, Gg^Eff, Re, Re, Re, Hh, Hh, Rd^Es, Re, Re, Re, Rb^Gvs, Rb^Gvs, Re^Gvs, Hh, Hh
Gg, Gg, Gg, Gg, Gg, Gg, Gg, Gg, Gg, Gg, Gg, Gg, Gg, Gg, Gg, Gg, Gg, Gg, Gg, Gg, Gg, Gg, Gg, Gg, Gg, Ww, Re, Ww^Bw/, Ww, Gg, Gg, Gs^Vh, Gg, Gg^Eff, Gg^Eff, Re^Gvs, Gg^Eff, Gg^Eff, Gll^Fp, Gll^Fp, Gll^Fp, Gg, Gg, Hh, Hh, Rd^Es, Re, Re^Gvs, Hh, Re^Gvs, Hh, Hh, Hh
Gg, Gg, Gg, Gg, Gg, Gg, Gg, Gg, Gg, Gg, Gg, Gg, Gg, Gg, Gg, Gg, Gg, Gg, Gg, Gg, Gg, Gg, Gg, Gg, Gg, Re, Gg, Gg, Ds, Ww, Ds, Gg, Ds, Gg, Gll^Fp, Gll^Fp, Gll^Fp, Gll^Fp, Gll^Fp, Gll^Fp, Gll^Fp, Gg, Hh, Hh^Fp, Hh^Fp, Rd^Es, Re, Hh^Fp, Hh^Fp, Hh, Hh, Hh, Hh^Fp
Gg, Gg, Gg, Gg, Gg, Gg, Gg, Gg, Gs^Vh, Gg, Gg, Gg, Re, Gg, Gg, Gg, Gg, Gg, Gg, Gg, Gg, Gg, Gg, Gg, Re, Re, Gg, Gg, Ds, Ww, Ww, Ds, Ww, Ww, Ww, Ww, Ww, Gll^Fp, Gll^Fp, Gll^Fp, Gll^Fp, Gll^Fp, Gll^Fp, Gll^Fp, Hh^Fp, Hh, Gs, Re, Hh, Hh, Hh^Fp, Hh^Fp, Hh^Fp
Gg, Gg, Gg, Gg, Gg, Gg, Gg, Gg, Re, Re, Re, Re, Gg, Re, Re, Gg, Re, Gg, Re, Re, Re, Re, Re, Re, Gg, Gg, Gg, Ds, Ww, Ww, Wo, Ww, Wo, Wo, Ww, Ww, Gll^Fp, Gll^Fp, Gll^Fp, Gll^Fp, Gll^Fp, Gll^Fmw, Gll^Fp, Gll^Fp, Gll^Fp, Gll^Fp, Re^Gvs, Re, Re, Hh, Hh, Hh, Hh
Gg, Gg, Gg, Gg, Gg, Gs^Vh, Re, 5 Re, Re, Gg, Gg, Gg, Gg, Gg, Gg, Re, Gg, Re, Gg, Gg, Gg, Gg, Gg, Gg, Gg, Gg, Gg, Ds, Ww, Ww, Wo, Wo, Wo, Ww, Gll^Fp, Gll^Fp, Gll^Fmw, Gll^Fp, Gll^Vct, Gll^Fp, Gll^Em, Gll^Fmw, Gll^Fmw, Gll^Fp, Gll^Fp, Gll^Fp, Gll^Fp, Re^Gvs, Gs^Vh, Re, Re, Rd^Es, Rd^Es
Gg, Gg, Gg, Gg, Gg, Gg, Re, Ch, Re, Gg, Gg, Gg, Gg, Gg, Gg, Gg, Gg, Gg, Gg, Gg, Gg, Gg, Gg, Gg, Gg, Gg, Gll^Fp, Ww, Ww, Wo, Wo, Wo, Wo, Ww, Ww, Gll^Fp, Gll^Fmw, Gll^Fp, Gll^Em, Gll^Ecf, Gll^Em, Gll^Fp, Gll^Fp, Gll^Fmw, Gll^Fp, Gll^Fp, Hh^Fp, Hh, Hh, Re^Gvs, Re, Rd^Es, Gs
Gg, Gg, Gg, Gg, Gg, Gg, Gg, Re, Gg, Gg, Gg, Gg, Gg, Gg, Gg, Gg, Gg, Gg, Gg, Gg, Gg, Gg, Gg, Gg, Gg, Gll^Fp, Gll^Fp, Ww, Ww, Wo, Wo, Ww, Gll^Fp, Ww, Gll^Em, Gll^Fp, Gll^Fmw, Gll^Fmw, Gll^Fmw, Gll^Fmw, Gll^Fp, Gll^Fp, Gll^Fp, Gll^Fmw, Gll^Fp, Hh^Fp, Hh, Hh, Hh, Re^Gvs, Gs, Re, Gs
Gg, Gg, Gg, Gg, Gg, Gg, Gg, Re, Gg, Gg, Gg, Gg, Gg, Gg, Gg, Gg, Gg, Gg, Gg, Gg, Gg, Gg, Gg, Gg, Gg, Gll^Fp, Gll^Fp, Gll^Fp, Gll^Fp, Ww, Ww, Ww, Gll^Fp, Gll^Fp, Gll^Fp, Gll^Fmw, Gll^Fp, Gll^Fp, Gll^Fp, Gll^Fp, Gg, Gll^Fp, Gg, Gll^Fp, Hh, Hh^Fp, Gll^Fp, Hh^Fp, Hh, Hh, Gg, Re, Re
