Gs^Fds, Gs^Fds, Gs^Fds, Gs^Fds, Gs^Fds, Gs^Fds, Gs^Fds, Gs^Fds, Gs^Fds, Gs^Fds, Gs^Fds, Gs^Fds, Gs^Fds, Gs^Fds, Gs^Fds, Gs^Fds, Gs^Fds, Gs^Fds, Gs^Fds, Gs^Fds, Hh^Fds, Hh^Fds, Hh^Fds, Hh, Hh, Hh, Hh, Hh^Fds, Hh^Fds, Gs^Fds, Hh^Fds, Gs^Fds, Wwr, Ww, Wo, Wo, Wo, Ww, Cv, Cv, Cv, Gs^Fds
Gs^Fds, Gs^Fds, Gs^Fds, Gs^Fds, Gs^Fds, Gs^Fds, Gs^Fds, Gs^Fds, Gs^Fds, Gs^Fds, Gs^Fds, Gs^Fds, Gs^Fds, Gs^Fds, Gs^Fds, Gs^Fds, Gs^Fds, Gs^_mhh, Hh^Fds, Hh^Fds, Hh^Fds, Hh^Fds, Hh^Fds, Hh^Fds, Hh^Fms, Hh^Fds, Hh^Fds, Hh^Fds, Hh^Fds, Hh^Fds, Hh^Fds, Hh^Fds, Hh^Qhhf, Ww, Ww, Ww, Wwr, Ww, Cv, 5 Kv, Cv, Gs^Fds
Gs^Fds, Gs^Fds, Gs^Fds, Gs^Fds, Gs^Fds, Gs^Fds, Gs^Fds, Gs^Fds, Gs^Fds, Gs^Fds, Gs^Fds, Gs^Fds, Gs^Fds, Gs^Fds, Hh^Fds, Hh^Fds, Hh^Fds, Hh^Fds, Hh^Fds, Hh^Fds, Hh^Qhhf, Hh, Hh^Fms, Hh^Fms, Hh^Fms, Hh^Fds, Hh^Fds, Hh^Fds, Hh, Hh^Ve, Hh^Qhhf, Hh^Qhh, Ww, Ww, Gs^Fds, Gs^Fds, Gs^Fds, Gs^Fds, Gs^Fds, Cv, Gs^Fds, Gs^Fds
Gs^Fds, Gs^Fds, Gs^Fds, Gs^Fds, Gs^Fms, Gs^Fds, Gs^Fds, Gs^Fds, Gs^Fds, Gs^Fds, Gll^Fp, Gs^Fds, Gs^Fms, Gs^Fds, Gs^Fds, Hh^Fds, Gs^Fms, Hh^Fds, Hh^Fp, Hh^Fp, Hh^Qhhf, Ww, Ww, Hh^Fms, Hh^Fds, Hh^Fds, Hh^Fds, Hh, Hh^Qhh, Hh^Fds, Hh^Qhhf, Ww, Gs^Fds, Ww, Gs^Fds, Gs^Fds, Gs^Fds, Gg^Ve, Gs^Fds, Gg, Gs^Fds, Gs^Fds
Gs^Fms, Gs^Fms, Gs^Fms, Gs^Fms, Hh^Fms, Hh^Fds, Gs^Fms, Gs^Fds, Gs^Fms, Gll^Fp, Hh^Fp, Gs^Fds, Gs^Fds, Gs^Fds, Gs^Fds, Gs^Fds, Hh^Fp, Hh^Fp, Hh^Fp, Hh^Fms, Gll^Fp, Gll^Qhhf, Ww, Gs^Fms, Gs^Fds, Hh^Fds, Gs^Fds, Hh^Fds, Hh^Qhh, Ww, Ww, Ww, Gs^Fds, Gs^Fds, Gs^Fms, Gs^Fds, Gs^Fms, Gs^Fds, Gs^Fds, Gg^Efm, Gs^Fds, Gs^Fds
Gs^Fds, Gs^Fms, Hh^Fms, Hh^Fms, Gs^Fds, Hh^Fds, Gs^Fms, Gs^Fms, Gs^Fms, Hh^Fp, Hh^Fp, Hh^Fp, Gll^Fp, Gll^Fp, Gll^Qhhf, Hh^Fp, Hh^Fp, Hh^Fms, Hh^Fp, Hh^Fp, Gll^Qhhf, Gll^Qhhf, Ww, Gs^Fms, Gs^Qhhf, Gs^Qhhf, Ww, Hh^Fds, Hh^Qhhf, Wo, Ww, Wwr, Gs^Fds, Gll^Fp, Gll^Fp, Gs^Fms, Gs^Fms, Gs^Fds, Gs, Gg^Efm, Gs^Fds, Gs^Fds
Gs^Fms, Hh^Fms, Hh^Fms, Hh^Fds, Hh^Fds, Gs^Fds, Hh, Hh^Fms, Hh^Fms, Hh^Fms, Hh^Fms, Gll^Fp, Gll^Fp, Gg^Ve, Gll^Efm, Gs^Qhhf, Gs^Qhhf, Gll^Fp, Gll^Qhhf, Gll^Fp, Gs^Qhhf, Ww, Gs^Qhhf, Gs^Fds, Ww, Ww, Gs^Fds, Ww, Wo, Wo, Gs^Fds, Gs^Fds, Gll^Fp, Gll^Fp, Gs^Fms, Gs^Fms, Gs^Fms, Gs^Fms, Gs, Gs^Fds, Gs^Fds, Gs^Fds
Gs^Fds, Hh^Fms, Hh^Fds, Hh^Fds, Hh, Hh, Hh^Fp, Hh^Fms, Hh^Fms, Hh^Fms, Hh^Fms, Gs^Fms, Gs^Fms, Gll^Efm, Gll^Efm, Gll^Efm, Gll^Efm, Gs^Qhhf, Gll^Fp, Gll^Qhhf, Gll^Qhhf, Ww, Ww, Gs^Qhhf, Ww, Gs^Fds, Gg^Ve, Gs^Fds, Ww, Gs^Fds, Gs^Fds, Gll^Fp, Gll^Em, Gs^Fms, Gg^Efm, Gg^Efm, Gg, Gs, Gs^Fds, Gg^Ve, Gs^Fds, Gs^Fds
Hh^Fds, Hh^Fds, Hh^Fds, Hh^Fds, Hh, Hh^Fp, Hh, Hh, Hh^Fms, Hh^Fms, Gs^Fms, Gs^Fds, Gs^Fms, Gll^Efm, Gs^Fds, Gs^Fds, Gs^Fds, Gs^Fms, Gs^Fms, Gll^Fp, Gs^Fms, Gs^Qhhf, Gs^Qhhf, Ww, Gs^Fds, Gs^Fds, Gs^Fds, Gs^Fds, Gs^Fds, Gs^Fds, Gll^Fp, Gll^Fp, Gll^Fp, Gs^Fds, Gs, Gll^Fp, Gll^Fp, Gs^Fds, Gs^Fds, Gs^Fds, Gs^Fds, Gs^Fds
Hh^Fds, Hh^Fds, Hh^Fms, Hh, Hh^Fds, Hh^Fp, Gs^Fds, Gs^Fms, Gs^Fds, Gs^Efm, Gs^Fds, Gs^Fms, Gs^Fms, Gs^Fds, Gs^Fds, Hh^Fds, Hh^Fds, Gs^Fms, Gs^Qhhf, Gll^Qhhf, Gs^Qhhf, Gs^Fds, Ww, Wo, Wo, Gs^Fds, Gs^Fds, Gs^Fds, Gs^Fds, Gs^Fds, Gll^Fp, Gll^Fp, Gs^Fms, Gs^Fms, Gs, Gll^Fp, Gll^Fp, Gs^Fds, Gll^Fp, Gs^Fds, Gs^Fds, Gs^Fds
Hh^Fds, Hh^Fds, Hh^Fms, Hh^Fds, Hh^Fds, Hh^Fds, Gs^Fds, Gs^Fds, Gs^Efm, Gg^Ve, Gs^Efm, Gs^Fms, Gll^Fp, Gs^Fds, Gs^Fds, Gs^Fds, Hh^Fp, Hh^Qhhf, Ww, Ww, Ww, Gs^Qhhf, Gs^Qhhf, Wo, Gs^Fds, Gs^Fds, Gs^Fds, Gs^Fds, Gs^Fds, Gs^Fms, Gs^Fms, Gs^Fms, Gg, Gg, Gs^Fms, Gs^Fms, Gs^Fms, Gll^Fp, Gll^Fp, Gs^Fds, Gs^Fds, Gs^Fds
Hh, Hh^Fds, Hh, Hh, Hh, Hh, Hh^Fds, Gs^Fds, Gs^Fms, Gs^Fms, Gs^Qhhf, Gll^Fp, Gs^Fds, Gs^Fds, Gll^Fp, Hh^Fp, Hh^Fds, Hh^Qhhf, Ww, Gs^Fds, Hh^Qhhf, Ww, Wwr, Wo, Gs^Fds, Gs^Fds, Gs^Fms, Gs^Fds, Gs^Fds, Gs^Fds, Gs^Fds, Gg, Gs^Fms, Gs^Efm, Gs^Fds, Gs^Fms, Gs^Fms, Gll^Fp, Gll^Em, Gs^Em, Gll^Fp, Gll^Fp
Hh, Hh, Gs^Fms, Gs^Fds, Hh, Hh^Fds, Hh^Fms, Gs^Fms, Gs^Fms, Gs^Fms, Gll^Em, Gll^Qhhf, Gll^Qhhf, Gll^Fp, Gll^Fp, Hh^Fds, Hh^Fds, Hh^Qhhf, Hh^Qhhf, Hh, Hh^Qhhf, Ww, Ww, Gs^Fds, Gs^Fms, Gs^Fds, Gs^Fms, Gs^Fds, Gs^Efm, Gs^Efm, Gg, Gg, Gs^Fms, Gs^Fms, Gg^Ve, Gs^Fms, Gs^Fms, Gll^Fp, Gll^Fp, Gll^Em, Gll^Fp, Gs^Fds
Gs^Fds, Gs^Fds, Hh^Fds, Hh^Fp, Hh^Fds, Hh^Fds, Hh^Fds, Gs^Fms, Gs^Fds, Gs^Fms, Gll^Em, Gll^Em, Gs^Qhhf, Gll^Fp, Gll^Fp, Gll^Fp, Hh^Fms, Hh^Fms, Hh^Fms, Hh, Gs^Fds, Hh^Qhhf, Ww, Gs^Fds, Gs^Fds, Gs^Fms, Gs^Fds, Gs^Fds, Gs, Gs, Gs^Efm, Gs^Fds, Gs^Fms, Gs^Fms, Gs^Fds, Gs^Fms, Gll^Fp, Gll^Fp, Gll^Fp, Gll^Fp, Gs^Fds, Gs^Fds
Gs^Fds, Gs^Fds, Gs^Fms, Gs^Fds, Gs^Fds, Hh, Hh^Fds, Gs^Fds, Gs^Fds, Gs^Fds, Gs^Fms, Gll^Em, Gll^Fp, Gll^Fp, Gll^Fp, Gll^Fp, Gll^Fp, Gs^Fms, Gg^Ve, Hh^Fds, Hh^Fds, Gs^Qhhf, Gs^Qhhf, Wwr, Gs^Fms, Gs^Fms, Gg^Ve, Gs^Fds, Gs, Gs^Fds, Gs^Fds, Gs^Fds, Gs^Fms, Gs^Fds, Gs^Fms, Gs^Fms, Gll^Fp, Gll^Fp, Gll^Fp, Gs^Fms, Gs^Fds, Gs^Fds
Gll^Fp, Gll^Fp, Gs^Fms, Gs^Fds, Gs^Fds, Hh^Fds, Gs^Fds, Hh^Fds, Gg, Gs^Fms, Gll^Fp, Gll^Fp, Gll^Fp, Gll^Fp, Gll^Fp, Gll^Fp, Gll^Fp, Gll^Fp, Gll^Fp, Hh^Fms, Hh^Fms, Gs^Fds, Gs^Qhhf, Ww, Ww, Gs^Fms, Gs^Fms, Gs^Fms, Gg, Gs^Fds, Gs^Fds, Gs^Fds, Gs^Fds, Gs^Fms, Gs^Fds, Gs, Gs^Fds, Gs^Fds, Gs^Fds, Gs^Fms, Gs^Fms, Gs^Fms
Gll^Fp, Gs^Fms, Gs^Fms, Gs^Fds, Gs^Fds, Gs^Fds, Gg, Gg, Gs^Fms, Gs^Fms, Gll^Fp, Gll^Fp, Gll^Qhhf, Gll^Qhhf, Gll^Qhhf, Gll^Qhhf, Gll^Qhhf, Gll^Fp, Gll^Qhhf, Gs^Fds, Gs^Fds, Gs^Fds, Gs^Qhhf, Ww, Gg, Gg, Gg, Gg, Gs^Fds, Gs^Fds, Gs^Fds, Gs^Fds, Gs^Fds, Gs^Fds, Gg^Efm, Gs, Gg^Ve, Gs^Fds, Gs^Fds, Gs^Fds, Gs^Fms, Gs^Fms
Gs^Fds, Gs^Fms, Gs^Fms, Gll^Fp, Gs^Fds, Gs^Fds, Gs^Fds, Gg, Gg, Gs^Fms, Gs^Fms, Gll^Qhhf, Gg, Gg, Gg, Gg, Gg, Gll^Qhhf, Gg, Gg, Gg, Gg, Gg, Ww^Bw/, Ww, Gs^Fds, Gs^Fds, Gs^Efm, Gs^Efm, Gs^Fds, Gs^Fds, Gs^Fms, Gs^Fms, Gs^Fds, Gs^Fds, Gs^Fds, Gs^Fds, Gs^Fds, Gs^Fds, Gs^Fds, Gs^Fms, Gs^Fms
Gll^Fp, Gll^Fp, Gll^Fp, Gll^Fp, Gs^Fds, Gs^Fds, Re^Vct, Gg, Ce, 4 Ke, Ce, Gg, Gs^Fds, Gs^Fds, Gs^Fds, Gs^Fds, Gs^Fds, Gg, Gs^Fds, Gs^Fds, Gs^Fds, Gs^Fds, Gs^Qhhf, Gs^Qhhf, Ww, Gs^Fds, Gs^Fds, Gg^Ve, Gs^Fds, Gs^Fds, Gs^Fms, Gs^Fms, Gll^Fp, Gll^Fp, Gll^Fp, Gll^Fp, Gs^Fds, Gs^Fds, Gs^Fms, Gs^Fms, Gs^Fms, Gs^Fms
Gll^Fp, Gll^Fp, Gs^Fds, Gs^Fms, Gs^Fds, Gs^Fds, Re^Edt, Re^Edt, Re, Ce, Re, Gs^Edt, Gs^Fds, Gs^Fds, Gs^Fds, Gs^Fds, Gs^Fds, Gg, Gg, Gs^Fds, Gs^Fds, Gs^Fds, Gs^Fds, Ww, Ww, Gs^Qhhf, Gs^Qhhf, Gs^Fds, Gs^Qhhf, Gs^Fms, Gs^Qhhf, Gs^Fms, Gs^Fms, Gll^Fp, Gs^Fds, Gll^Fp, Gll^Fp, Gs, Gs^Fds, Gs^Fds, Gs^Fds, Gs^Fms
Gll^Fp, Gll^Fp, Gll^Fp, Gs^Fds, Gs^Fds, Gg, Gs^Ecf, Gs^Fds, Re^Vct, Re, Gs^Ecf, Re^Vct, Gs^Edt, Gs^Fds, Gs^Qhhf, Gs^Qhhf, Ww, Gs^Fds, Ww^Bw|, Gs^Qhhf, Gs^Qhhf, Gs^Qhhf, Ww, Gs^Qhhf, Ww, Ww, Ww, Gs^Qhhf, Ww, Gs^Qhhf, Ww, Gs^Qhhf, Gs^Fms, Gs^Fds, Gs^Fds, Gs^Fds, Gs^Fds, Gs, Gg^Efm, Gs^Fds, Gs^Fds, Gs^Fds
Gll^Fp, Gll^Fp, Gll^Qhhf, Gll^Fp, Gll^Qhhf, Gs^Fds, Gs^Qhhf, Gs^Qhhf, Gs^Qhhf, Gs^Fds, Rb, Re, Gs^Fms, Gs^Fds, Wo, Ww, Gs^Fds, Ww, Gg, Ww, Ww, Ww, 3 Ke, Ww, Gs^Fds, Gs^Fds, Gs^Fds, Ww, Gs^Fds, Ww, Ww, Gs^Qhhf, Gs^Qhhf, Gs^Fds, Gg^Ve, Gs^Fds, Gs^Fds, Gs^Fds, Gs^Fds, Gg^Ve, Gs^Fds, Gll^Fmw
Gll^Qhhf, Gll^Qhhf, Wo, Gll^Qhhf, Ww, Gs^Qhhf, Ww, Ww, Ww, Ww, Wwr, Gs^Fds, Ww, Gs^Fds, Wo, Gs^Fds, Gs^Fds, Gs^Fds, Gg, Gs^Fds, Gs^Fds, Ce, Ce, Ww, Gs^Fds, Re^Vct, Re, Gs^Fds, Re^Vct, Gs^Fds, Gs^Fds, Wwr, Gs^Fms, Gs, Gg, Gs, Gs^Fds, Gs^Fds, Gll^Fp, Gs^Fds, Gs^Fms, Ss
Ww, Wo, Gs^Fds, Wo, Wwr, Ww, Gs^Fds, Gs^Fds, Gs^Fds, Gs^Fds, Gs^Fds, Ww, Rb^Edt, Ww, Gs^Fds, Gs^Fds, Gs^Fds, Gs^Fds, Re^Vct, Gg, Gs^Fds, Ce, Gs^Fds, Ww, Ww, Rb, Ww, Gg, Gs^Fds, Gs^Fds, Ww, Wo, Gs^Fms, Gs^Fms, Gs^Fds, Gs^Fds, Gs^Fds, Gs^Fds, Gll^Fp, Gll^Fp, Gs^Fms, Gs^Fms
Gs^Fds, Gs^Fds, Gs^Fds, Gs^Fds, Gs^Fds, Gs^Fds, Gs^Fms, Gs^Fms, Gs^Fds, Gs^Fds, Gs^Fds, Gs^Fds, Gs^Fds, Rb^Edt, Gs^Fds, Gs^Fds, Gg, Gs^Fds, Re^Edt, Re^Edt, Re^Edt, Re, Gs^Fds, Gs^Fds, Rb, Ww^Bw|, Gs^Fds, Ww, Ww, Ww, Gs^Fds, Wo, Wwr, Ww^Ewl, Gs^Fds, Gs^Fds, Gs^Fds, Gs^Fds, Gll^Fp, Gll^Fp, Gs^Fms, Gs^Fms
Gs^Fds, Gs^Fds, Gll^Fp, Gll^Fp, Gs^Fms, Gs^Fms, Gs^Fds, Gs^Fds, Gs^Fds, Gg^Efm, Gg^Efm, Gg, Gg, Re^Vct, Gs^Fds, Gs^Fds, Gs^Fds, Gg, Gs^Ecf, Gs^Fds, Re^Vct, Gg, Gs^Fds, Re^Vct, Re^Edt, Rb, Gg, Gs^Fds, Gs^Fds, Gs^Fds, Gs^Fds, Ww, Gs^Fds, Wwr, Wo, Gs^Fds, Gs^Qhhf, Gll^Fp, Gs^Qhhf, Gs^Qhhf, Gs^Qhhf, Gs^Qhhf
Gs^Fds, Gll^Fp, Gs^Fms, Gs^Fms, Gs^Fms, Gg^Em, Gg, Gg, Gg, Gg^Efm, Gs^Fds, Gs^Fms, Gs^Fds, Gs^Fds, Gs^Fds, Gs^Fds, Gs^Fds, Gg, Gs^Fds, Gs^Fds, Gs^Fds, Gs^Fds, Gs^Ecf, Gs^Edt, Gs^Fds, Gs^Ecf, Re, Gs^Fds, Re^Vct, Gs^Fds, Gs^Ecf, Gs^Fds, Gs^Fds, Wo, Wo, Gs^Qhhf, Wwr, Gs^Qhhf, Wo, Ww, Wwr, Ww
Gs^Fds, Gs^Fms, Gs^Fms, Gs^Fms, Gg^Em, Gg, Gs^Fds, Gg, Rb^Gvs, Gg, Gg, Gs^Fms, Gs^Fms, Gs^Fms, Gs^Fms, Gll^Fp, Gll^Fp, Gs^Fds, Gll^Fp, Gs^Fds, Gs^Fds, Gs^Fds, Gs^Fds, Gs^Fds, Gs^Fds, Gs^Fds, Re^Edt, Re^Edt, Re, Gg, Gs^Fds, Gs^Fds, Re^Vct, Gs^Fms, Gs^Fms, Ww, Gs^Qhhf, Wo, Ww^Ewf, Gs^Fds, Gs^Fds, Ww
Gs^Fds, Gs^Fds, Gs^Fms, Gs^Fms, Gg^Em, Gs^Fds, Gs^Fms, Gs^Vl, Rb^Gvs, Rb^Gvs, Gs^Fds, Gg, Gg^Efm, Gs^Fds, Gs^Fds, Gll^Fp, Gll^Fp, Gll^Fp, Gs^Fms, Gs^Fds, Gs^Fms, Gs^Fds, Gs^Fds, Gs^Fds, Gs^Fds, Re^Vct, Gs^Ecf, Gs^Fds, Gs^Fds, Gg, Ce, 2 Ke, Ce, Gs^Fds, Gs^Fms, Gs^Fms, Gs^Fms, Gs^Qhhf, Gs^Qhhf, Gs^Fds, Gs^Fds, Gs^Fds
Gs^Fds, Gs^Fds, Gs^Fds, Gs^Fms, Gs^Fms, Gs^Fms, Gs^Fds, Gs^Fds, Gs^Fds, Rb^Gvs, Gs^Fds, Gs^Fds, Gs^Fds, Gg^Efm, Gs^Fds, Gs^Fds, Gs^Fds, Gs^Fms, Gs^Fms, Gs^Fms, Gs^Fms, Gs^Fms, Gs^Fms, Gs^Fds, Gg, Gg, Gs^Fms, Gs^Fms, Gs^Fds, Rb, Rb, Ce, Re^Edt, Gs^Fds, Gs^Fds, Gs^Fms, Gll^Fp, Gs^Fds, Gll^Fp, Gs^Fds, Gs^Fds, Gs^Fds
Gs^Fds, Gs^Fds, Gs^Fds, Gs^Fms, Gs^Fds, Gs^Fds, Gs^Fds, Gs^Fds, Gs^Fds, Gs^Fds, Gs^Fds, Gs^Fds, Gs^Fds, Gg, Gs^Fds, Gs^Fds, Gs^Fms, Gs^Fms, Gs^Fms, Gs^Fms, Ss^Ewl, Gs^Fms, Ss^Ewl, Gs^Fds, Gg, Gs^Fds, Gs^Fds, Gs^Fms, Gs^Fms, Rb^Edt, Gs^Fds, Re^Edt, Gs^Edt, Re^Vct, Gs^Fds, Gs^Fds, Gll^Fp, Gll^Fp, Gll^Fp, Gs^Fds, Gll^Fp, Gs^Fds
Gs^Fds, Gs^Fds, Gs^Fds, Gs^Fds, Gs^Fds, Gs^Fds, Gs^Fds, Gs^Fds, Gs^Fds, Gs^Fds, Gs^Fds, Gs^Fds, Gg^Efm, Gg^Efm, Gs^Fds, Gs^Fds, Gs^Fds, Gs^Fms, Gs^Fds, Gs^Fds, Ss^Ewl, Gg^Em, Gg^Em, Gg, Gs^Fds, Gg^Efm, Gg, Gs^Fms, Gs^Fms, Gs^Fds, Gs^Fds, Gs^Ecf, Gs^Fds, Gs^Fds, Gs^Fds, Gs^Fds, Gs^Fms, Gs^Fms, Gs^Fms, Gll^Fp, Gs^Fds, Gs^Fds
Gs^Fds, Gs^Fds, Gs^Fds, Gs^Fds, Gs^Fds, Gs^Fms, Gll^Fp, Gll^Fp, Gs^Fms, Gs^Fms, Gs^Fms, Gs^Fms, Gs^Fds, Gg, Gg, Gg, Gg, Gs^Fds, Gs^Fms, Ss^Ewl, Gg^Emf, Ss^Vhs, Ss^Ewl, Gg, Gs^Fds, Gg^Efm, Gg^Efm, Gg^Efm, Gg^Efm, Gs^Fds, Gg, Gg, Gs^Fds, Gs^Fds, Gs^Fds, Gs^Fds, Gs^Fms, Gs^Fms, Gs^Fms, Gs^Fds, Gs^Fds, Gs^Fds
Gs^Fds, Gs^Fds, Gs^Fds, Gs^Fms, Gs^Fms, Gs^Fms, Gs^Fms, Gll^Fp, Gs^Fms, Gs^Fds, Gs^Fds, Gs^Fms, Gs^Fds, Gs^Fds, Gs^Fds, Gs^Fds, Gs^Fds, Gs^Fds, Gll^Fp, Gs^Fds, Gg^Em, Ss, Gs^Fds, Gs^Fds, Gs^Fds, Gs^Fds, Gs^Fds, Gg, Gs^Fds, Gg, Gs^Fds, Re, Re, Gg, Gs^Fds, Gs^Fms, Gs^Fds, Gs^Fms, Gg^Efm, Gg, Gg, Gs^Fds
Gs^Fds, Gs^Fds, Gs^Fds, Gs^Fms, Gs^Fms, Gll^Fp, Gll^Fp, Gll^Fp, Gll^Fp, Gll^Fp, Gll^Fp, Gll^Fp, Gs^Fds, Gs^Fds, Gs^Fds, Gs^Fds, Gs^Fds, Gs^Fds, Gll^Fp, Gs^Fms, Gs^Fms, Gg, Ss^Ewl, Gs^Fds, Gs^Fds, Gs^Fds, Gs^Fds, Gs^Fds, Gs^Fds, Gs^Fds, Gs^Fds, Gs^Fds, Re, Gs^Fds, Gs^Fms, Gs^Fms, Gs^Fds, Gg, Gg^Efm, Gg^Efm, Gs^Fds, Gg
Gg^Eff, Gg^Eff, Gg^Eff, Gs^Fds, Gs^Fds, Gs^Fds, Gs^Fms, Gs^Fms, Gs^Fds, Gs^Fds, Gs^Fds, Gll^Fp, Gs^Fds, Gs^Fds, Gs^Fds, Gs^Fds, Gs^Vl, Gg, Gs^Es, Gs^Fms, Gs^Fms, Gs^Fms, Gs^Fds, Gs^Fds, Gs^Fms, Gs^Fms, Gll^Fp, Gs^Fds, Gs^Fms, Gs^Fds, Gs^Fds, Gg, Gg, Gs^Fds, Gs^Fds, Gs^Fds, Gg, Gg, Gs^Fds, Gg, Gs^Fds, Gs^Fds
Rb^Gvs, Rb^Gvs, Rb^Gvs, Gg^Eff, Gs^Fds, Gs^Fds, Gs^Fms, Gs^Fms, Gs^Fds, Gs^Fds, Gs^Fds, Gs^Fds, Gs^Fms, Gs^Fms, Gs^Fds, Gs^Fds, Gs^Fds, Gg, Gs^Fds, Gs^Fms, Gs^Fms, Gs^Fds, Gs^Fds, Gs^Fds, Gg^Fet, Gll^Fp, Gll^Fp, Gll^Fp, Gs^Fds, Gs^Fms, Gs^Fms, Gs^Fds, Gs^Fds, Gg^Edt, Re^Edt, Gg, Re^Edt, Gs^Fds, Gs^Fds, Gs^Fds, Gs^Fms, Gs^Fds
Rb^Gvs, Rb^Gvs, Rb^Gvs, Gs^Vh, Gg^Eff, Gs^Fds, Gs^Fms, Gs^Fms, Gg^Efm, Gg^Efm, Gs^Fds, Gs^Fds, Gs^Fms, Gll^Fp, Gll^Fp, Gs^Fds, Gs^Fds, Gg^Es, Gg^Es, Gs^Fds, Gs^Fds, Gs^Fms, Gs^Fds, Gs^Efm, Gs^Efm, Gs^Efm, Gs^Fds, Gs^Fms, Gs^Fms, Gs^Fds, Gs^Fds, Gs^Fds, Gs^Fds, Re^Edt, Co^Edt, Co^Edt, Co, Gs^Fds, Gs^Fms, Gs^Fms, Gs^Fds, Gs^Fds
Rb^Gvs, Rb^Gvs, Re, Re, Rb^Gvs, Gg^Eff, Gs^Fds, Gs^Fms, Gg, Gs^Vc, Gg, Gs^Fds, Gs^Fms, Gll^Fp, Gs^Fds, Gs^Fds, Gs^Fds, Gs^Es, Gg, Gs^Fds, Gs^Fds, Gs^Fds, Gs^Fds, Gs^Fds, Gs^Fds, Gs^Fds, Gs^Fds, Gs^Fms, Gs^Fms, Gs^Fds, Gs^Fms, Gg, Gs^Fds, Re, Co^Edt, 1 Ko, Co, Gs^Fds, Gs^Fms, Gs^Fms, Gs^Fms, Gs^Fds
Rb^Gvs, Rb^Gvs, Re, Rb^Gvs, Rb^Gvs, Rb^Gvs, Gs^Fds, Gs^Fms, Re, Re, Gs^Fms, Gs^Fms, Gs^Fds, Gs^Fds, Gs^Fms, Gs^Fms, Gs^Fds, Gs^Fds, Gg, Gs^Fds, Re, Gg, Gg, Gs^Fds, Gs^Fds, Gs^Fds, Gs^Vh, Gs^Fds, Gs^Fms, Gs^Fms, Gs^Fms, Gg^Efm, Re, Gg, Gs^Fds, Co, Re, Re, Gll^Fp, Gll^Fp, Gll^Fp, Gs^Fms
Re, Re, Rb^Gvs, Rb^Gvs, Rb^Gvs, Gs^Vh, Re, Re, Gg, Gs^Fds, Gs^Fms, Gs^Fms, Gs^Fds, Gs^Fds, Gs^Fms, Gs^Fds, Gs^Fms, Gs^Fds, Gs^Vh, Re, Rb^Gvs, Re, Re, Gg, Re, Re, Re, Re, Re, Gg, Gg, Re, Gg, Gs^Fds, Gs^Fds, Gs^Fds, Gg, Re, Re, Gll^Fp, Gll^Fp, Gs^Fms
Rb^Gvs, Rb^Gvs, Rb^Gvs, Rb^Gvs, Rb^Gvs, Rb^Gvs, Gg^Eff, Gg, Gg, Gg, Gs^Fds, Gs^Fds, Gs^Fds, Gs^Fms, Gs^Fms, Gs^Fms, Gg^Eff, Gg^Eff, Rb^Gvs, Rb^Gvs, Rb^Gvs, Rb^Gvs, Gg, Gg, Gs^Fds, Gg, Gs^Fds, Gg, Gs^Fds, Gg, Gs^Fds, Gs^Fds, Gs^Fds, Gg, Gs^Fds, Gs^Fds, Gs^Fds, Gs^Fds, Gs^Fds, Gg, Gs^Fms, Gs^Fms
Rb^Gvs, Rb^Gvs, Rb^Gvs, Rb^Gvs, Gg^Eff, Gg^Eff, Gg, Gg, Gg, Gs^Fds, Gs^Fds, Gs^Fds, Gs^Fds, Gs^Fms, Gs^Fms, Gs^Fms, Rb^Gvs, Rb^Gvs, Rb^Gvs, Rb^Gvs, Rb^Gvs, Rb^Gvs, Gs^Fds, Gs^Fds, Gs^Fds, Gs^Fds, Gs^Fds, Gs^Fds, Gs^Fds, Gs^Fds, Gs^Fds, Gs^Fds, Gs^Fds, Gg, Gg, Gs^Fds, Gs^Fds, Gs^Fds, Gs^Fds, Re, Gs^Fds, Gs^Fms
