Gg^Es, Gs^Fms, Gs^Fds, Gs^Fds, Gs^Fds, Gs^Fds, Gs^Fds, Gs^Fds, Gs^Fds, Gs^Fds, Gs^Fms, Gs^Fds, Gs^Fds, Gs^Fds, Gs^Fds, Gs^Fds, Ww, Gs^Fds, Gs, Gs^Fms, Gll^Fp, Gs^Fds, Gs^Fds, Gs^Fms, Gs^Fds, Gll^Fp, Gll^Fmf, Gs^Fds, Gll^Fmf, Gs^Fms, Gll^Fp, Gs^Fds, Gs^Fds, Gll^Fp, Gs^Fds, Gs^Fds, Gs^Fds, Gs^Fds, Gs^Fds, Gs^Fms, Gll^Fp, Gs^Fds
Gs^Fds, Gs^Fms, Gs, Gs^Fds, Gll^Em, Gs^Fds, Gg^Ve, Gs^Fds, Gg^Es, Gs^Fds, Gs^Fms, Gll^Fp, Gs^Fds, Gs^Fds, Gs^Fds, Gs^Fds, Ww, Gs^Fds, Gs^Fds, Gs^Fds, Gll, Gll^Fmf, Gs^Fms, Gs^Fds, Gll^Fp, Gs^Fds, Gll^Fp, Gll^Fmf, Gs^Fds, Gs^Fds, Gll^Fmf, Gll^Fmf, Gs^Fds, Gs^Fds, Gs^Fds, Gs^Fds, Gs^Fms, Gs^Fds, Gs^Fds, Gs^Fds, Gs^Es, Gs^Fds
Gll^Fp, Gs^Fds, Gll^Fp, Gs^Fds, Gs^Fds, Gs^Fds, Gg, Gs^Fds, Gs^Fds, Gs^Fms, Gs^Fds, Gs^Fds, Gs^Fds, Gll^Fp, Gs^Fms, Gs^Fds, Ww, Gs^Fms, Gs^Fms, Gs^Fds, Gs^Fds, Gs^Fds, Gs^Fds, Gs^Fms, Gs^Fds, Gs^Fds, Gll^Fp, Gs^Fds, Gg^Es, Gs^Fds, Gll^Fmf, Gg, Gll^Fp, Gs^Fds, Gs^Fds, Gll^Fp, Gs^Fds, Gll^Fmf, Gs^Fds, Gs^Fds, Gll^Fp, Gll^Fp
Gll^Fp, Gll^Fp, Gs^Fms, Gs^Fds, Gs^Fds, Gs^Fds, Gs^Fds, Gg, Gs^Fds, Gs^Fms, Gll^Fp, Gs^Fds, Gs^Fms, Gs^Fds, Gs^Fds, Gs^Fds, Ww, Gs^Fds, Gg, Gs^Fds, Gs^Fms, Gs^Fds, Gs^Fds, Gs^Fds, Gg, Gs^Fms, Gg, Gs^Fms, Gg^Ve, Gs^Fms, Gg, Gs^Fds, Gs^Fds, Gs^Fds, Gs^Fds, Gs^Fds, Cv, Gs^Fds, Kv^Ebn, Gs^Fds, Gs^Fds, Gs^Fds
Gll^Fp, Gs^Fds, Gs^Fds, Gs^Fds, Gs^Fds, Gs^Fds, Gs^Fds, Gg, Gs^Fds, Gs^Fds, Gs^Fds, Gs^Fds, Gs^Fms, Gs^Fms, Gg, Gll^Fp, Gg, Ww^Bsb/, Gs^Fds, Gg, Gs, Gg^Ve, Gg^Es, Gg, Gs^Fds, Gg, Gs^Fds, Gg, Gs^Fms, Gg, Gs^Fds, Gg, Gs^Fds, Gs^Fds, Rp, Cv, 5 Kv, Gg^Fet, Gs^Fds, Gs^Fds, Gs^Fds, Gll^Em
Gs^Fds, Gs^Fds, Gll^Fp, Gs^Fds, Gg, Gg, Gg, Gg, Gg, Gs^Fds, Gs^Fds, Gs^Fds, Gg, Gg, Gs^Fds, Gg, Gs^Fds, Ww, Ww, Gs^Fds, Gll^Fp, Gs^Fms, Gs^Fds, Gs^Fds, Gs^Fds, Gs^Fms, Gs^Fds, Gll^Fp, Gs^Fds, Gll^Fmf, Gs^Fds, Gg, Gll^Fmf, Gg^Ve, Rp, Rp, Cv, Cv, Gs^Fds, Gs^Fms, Gs^Fms, Gs^Fds
Gll^Fp, Gs^Fds, Gg, Gg^Ve, Gs^Fms, Gs^Fds, Gs^Fds, Gs^Fds, Gg, Gs^Fds, Gg, Gg^Ve, Gs^Fms, Gs^Fds, Gs^Fds, Gll^Fmf, Gs, Gll^Fmf, Gs^Fds, Ww, Gll^Fp, Gs^Fds, Gs^Fds, Gll^Fmf, Gs^Fms, Cv^Ebn, Gs^Fds, Gll^Em, Gll^Fmf, Gs^Fds, Gg, Gg, Gg, Gg, Gg^Ve, Rp, Gs^Fds, Gs^Fds, Gs^Fds, Gs^Fms, Gs^Fds, Gs^Fds
Gs^Fds, Gs^Fds, Gs^Fms, Gs^Fms, Gs^Fds, Gs^Fms, Gs^Fds, Gs^Fds, Gs^Fds, Gg, Gg, Gs^Fds, Gs^Fds, Gs^Fds, Gs^Fds, Gs^Fms, Gs^Fds, Gs^Fds, Gs^Fds, Ww, Ww, Gs^Fds, Gs^Fds, Gs^Fds, Gs^Fms, Gs^Fds, Gs^Fms, Gs^Fds, Gs^Fds, Gs^Fds, Gs, Gs^Fds, Gs^Fms, Gs^Fds, Gs^Fms, Gg, Gg, Gs^Fds, Gs^Fds, Gs^Fds, Gll^Fp, Gs^Fds
Gs^Fds, Gs^Fds, Gs^Fds, Gs^Fds, Gs^Fds, Gs^Fds, Gs^Fds, Gll^Fp, Gs^Fds, Gs^Fms, Gg, Gs^Fds, Gs^Fds, Gs^Fms, Gs^Fds, Gs^Fds, Gs^Fds, Gs^Fds, Gs^Fds, Gs^Fds, Ww, Gs^Fds, Gll^Fp, Gs^Fds, Gll^Em, Gs^Fds, Gs^Fds, Gs^Fds, Gg, Gg, Gs^Fds, Gll^Fmf, Gs^Fms, Gs^Fds, Gs^Fms, Gll^Em, Gg, Gs^Fds, Gll^Fmf, Gll^Fmf, Gs^Fds, Gs^Fds
Gll^Fp, Gll, Gs^Fds, Gs^Fds, Gs^Fds, Gs^Fds, Gs^Fms, Gs^Fds, Gs^Fds, Gg, Gs^Fds, Gs^Fds, Gs^Fds, Gs^Fds, Gs^Fds, Gs^Fms, Gs^Fds, Gs^Fds, Gs^Fds, Gs^Es, Gll, Ww, Gg, Gg, Gg^Ve, Gg, Gg, Gll, Gs^Fds, Gll^Fmf, Gs^Fds, Gs^Fds, Gs^Fds, Gs^Fds, Gs^Fds, Gs^Fds, Gs^Fds, Gg, Gg, Gs^Fds, Gs^Fds, Gs^Fds
Gll^Fp, Gs^Fds, Gs^Fds, Gs^Fds, Gs^Fms, Gs^Fds, Gs^Fds, Gs^Fds, Gs^Fms, Gg, Gs^Fds, Gs^Fds, Gll^Fmf, Gs^Fds, Gs^Fms, Gs^Fds, Gs^Fds, Gs, Gs^Fds, Gs^Fds, Ww, Ww, Gs^Fds, Gll^Fp, Gs^Fds, Gs^Fms, Gs^Fds, Gg, Gs, Gs^Fds, Gll^Fp, Gs^Fds, Gs^Fds, Gs^Fds, Gs^Fms, Gs^Fds, Gs^Fms, Gs^Fms, Gg, Gs, Gs^Fds, Gs^Fds
Gs^Fds, Gs^Fds, Gs, Gll^Fp, Gg, Gs^Fms, Gs^Fds, Gs^Fds, Gs^Fds, Gg, Gg, Gs^Fds, Gs^Fds, Gs^Fds, Gs^Fds, Gs^Fms, Gll^Fp, Gll^Em, Gs^Fds, Gs^Fds, Ww, Gs^Fds, Gll^Fmf, Gs^Fds, Gs^Fms, Gs^Fds, Gs^Fms, Gs^Fds, Gs^Fds, Gll, Gll^Fmf, Gs^Fds, Gs^Fds, Cv^Ebn, Gll^Fmf, Gs^Fds, Gll^Fmf, Gs^Fds, Gg^Ve, Gs^Fds, Gs^Fds, Gll^Fp
Gs^Fms, Gs^Fms, Gll^Fmf, Gs^Fds, Gs^Fds, Gs^Fds, Gs^Fds, Gs^Fds, Gs^Fds, Gs^Fds, Cvr^Ebn, Gs^Fds, Gs^Fds, Gs^Fds, Gg, Gs^Fds, Gs^Fds, Gs^Fms, Ww, Ww, Gs^Fds, Gs^Fms, Gs^Fds, Gs^Fds, Gs^Fds, Gs^Fds, Gs^Fds, Gs^Fds, Gg^Ve, Gg, Gs^Fds, Gs^Fds, Gs^Fds, Gs^Fds, Gll^Fmf, Gs^Fds, Gs^Fds, Gg, Gs^Fds, Gs^Fms, Gs^Fms, Gs^Fms
Gs^Fds, Gs^Fms, Gll^Fp, Gs^Fds, Gs^Fds, Gs^Fms, Gs^Fms, Gs^Fds, Gs^Fds, Gs^Fds, Gs^Fms, Gs^Fds, Gs^Fds, Gs^Fds, Gs, Gs^Fms, Gs^Fds, Gs^Fds, Ww, Gll, Gs^Fds, Gs^Fds, Gll^Fp, Cvr^Ebn, Gs^Fds, Gll^Fp, Gs^Fds, Gs^Fms, Gs^Fds, Gg, Gg, Gs^Fds, Gs^Fms, Gs^Fds, Gll^Fmf, Gll^Fp, Gs^Fds, Gg, Gll^Fp, Gll^Fp, Gs^Fds, Gs^Fds
Gs^Fds, Gs^Fds, Gs^Fms, Gs^Fms, Gs^Fms, Gs^Fds, Gs^Fds, Gs^Fds, Gs^Fds, Gs^Fds, Gs^Fds, Gs^Fds, Gs^Fds, Gs^Fds, Gll^Fp, Gs^Fds, Gs^Fms, Ww, Ww, Gs^Fds, Gs^Fds, Gll^Fp, Gs^Fds, Gs^Fms, Gs^Fms, Gs^Fds, Gll^Fp, Gs^Fds, Gs, Gg, Gs^Es, Gll, Gg, Gs, Gg, Gs^Fds, Gg, Gg^Es, Gs^Fds, Gs^Fds, Gs^Fds, Gs^Fds
Gs^Fds, Gll^Fp, Gs^Fds, Gs^Fds, Gs, Gs, Gs^Fds, Gs^Fds, Gs^Fds, Gs^Fds, Gs^Fds, Gs^Fds, Gs^Fds, Gs^Fds, Gs^Fds, Gs^Fds, Gs^Fds, Gs^Fds, Ww, Gll^Fmf, Gs^Fds, Gs^Fds, Gs^Fds, Gll^Fp, Gg, Gg, Gg, Gg, Gll^Fmf, Gs^Fds, Gs^Fds, Gg, Gll^Fp, Gs^Fds, Gs^Fds, Gg^Ve, Gs^Fds, Gs^Fds, Gs^Fds, Gll^Fp, Gll^Fmf, Gll
Gs^Fds, Gs^Fds, Gs, Gs, Gs, Gs, Gs^Fds, Gs^Fds, Gs^Fds, Gs^Fds, Gs^Fds, Gs^Fds, Gs^Fds, Gs^Fms, Gs^Fds, Gs^Fds, Gs^Fds, Ww, Gs^Fds, Gs^Fds, Gll^Fp, Gs^Fds, Gs^Fds, Gs, Gg, Gs^Fds, Gll^Fmf, Gs^Fds, Gs^Fds, Gs^Fms, Ss, Gs^Fds, Ss, Gs^Fds, Ss, Gll^Fmw, Ss, Gll^Fmf, Gll^Fmf, Gll^Fp, Ss, Gs^Fds
Gs, Gs, Re, Ce, Re, Re, Re^Ecf, Gs^Edt, Gs^Edt, Gs, Re^Vct, Gs^Fds, Gs^Fds, Gs^Fds, Gs^Fds, Gs^Fds, Gs^Fds, Ww, Ww, Gs^Fds, Gs^Fds, Gs^Fds, Gg, Gg^Ve, Gs^Fds, Gs^Fds, Gs^Fms, Ss, Ss, Ss, Ss, Ss, Ss, Ww^Ewl, Ww^Ewl, Ww^Ewl, Ss, Ss, Ss, Ss, Ss, Ss
Gs^Fms, Gs^Fds, Gs, Re, Gs^Edt, Gs^Edt, Gs^Fds, Gs, Re^Vct, 4 Ke, Ce, Re^Vct, Re, Gs^Fds, Gs, Gs, Gs, Gs, Ww, Gs^Fds, Gll^Fmf, Gs^Fds, Gg, Gll^Fp, Gs^Fds, Gll^Fp, Gll^Fp, Gll^Fp, Gs^Fds, Ww^Ewl, Gll^Fmf, Ss, Gll^Fmf, Ss, Gs^Fms, Ss, Gll^Fmf, Ss, Ss, Ww^Ewl, Ww^Ewl, Ss
Gs^Fms, Gs^Fms, Gs^Fms, Gs^Fms, Gs^Fds, Gs^Fms, Gs^Fms, Gs^Fds, Re^Vct, Ce, Re^Edt, Re^Edt, Re^Ecf, Re, Re^Edt, Ce, Gs, Gs, Gs^Fds, Ww, Ww, Gll^Fmf, Ww^Bsb|, Gs^Fds, Gs^Fds, Gs^Fds, Gll^Fmf, Gs^Fms, Gll^Fmf, Gll^Fmf, Gll^Fmw, Gll^Fmf, Ss^Vhs, Gll^Fmf, Gll^Fp, Gll^Fmf, Gll^Fmf, Gll^Fmw, Gll^Fmf, Ss, Ss, Ss
Gll^Es, Gs^Fds, Gs^Fds, Gs^Fds, Gs^Fms, Gs^Fms, Gs^Fds, Gs^Fds, Gs, Gs, Gs^Fds, Gs^Fms, Gs^Fds, Gs^Fds, Re^Edt, Re^Edt, Gs^Edt, Gs, Gs^Fds, Ww, Gs^Fds, Ww, Gs, Ww, Ww, Gs^Fds, Gs^Fds, Gs^Fds, Gs^Fms, Gs^Fms, Ss, Gll^Fmf, Ss, Gll^Fmf, Ss, Gll^Fp, Gll^Fmf, Gll^Fp, Gg, Gll^Fmf, Gs^Fms, Gs^Fds
Gs^Fds, Gs^Fds, Gs^Fds, Gs^Fds, Gs^Fds, Gs^Fds, Gs^Fms, Gs^Fds, Gs, Gs^Fds, Gs^Fds, Gs^Fds, Gs^Fms, Gs, Gs^Vl, Gs, Gs, Gs, Gs, Gs^Fds, Re^Vct, Gs, Ce, Ww^Ewl, Ww, Gs^Fds, Ww, Gll^Em, Gs^Fms, Gll^Fmw, Gs^Fms, Ss, Ss, Ss, Gll^Fmf, Gll^Fp, Ss, Gll^Fmf, Ww^Ewl, Gll^Fmf, Ss, Gll^Fmw
Gs^Fds, Gs^Fds, Gs^Fds, Gs^Fds, Gs^Fds, Gs^Fds, Gll^Fmf, Gs^Fds, Gs, Gg, Gs^Fms, Gs^Fms, Gs, Gs, Gs^Fds, Gs^Fms, Gs, Re^Edt, Re^Edt, Re^Vct, Ce, 3 Ke, Re^Vct, Gs^Fds, Gs^Fds, Ww, Gs, Ww, Ww, Ww, Ww, Gll^Fmf, Gll^Em, Gll^Fmf, Gll^Fmw, Gll^Fmf, Gs, Ss, Gll^Fmw, Ss, Ss, Ss
Gll^Fp, Gll^Fp, Gs^Fds, Gs^Fms, Gs^Fms, Gs^Vl, Gs, Gs, Gs^Fds, Gg, Gg, Gs^Fms, Gs^Fms, Gs^Fms, Gs^Fds, Gs, Gs^Fms, Gs^Fds, Gs^Fds, Re, Re^Ecf, Ce, Re^Vct, Gs, Ww, Ww, Re, Gs^Fds, Gs^Fds, Ww^Ewl, Ww, Gll^Fmw, Ss, Ss, Ss, Gll^Fmw, Ss, Gll^Fmw, Gll^Fmw, Ss, Gll^Fmf, Ss
Gs^Fms, Gs^Fds, Gs^Fds, Gll^Fp, Gs^Fms, Gs, Gs, Gll^Fp, Gs^Fds, Gs^Fms, Gs^Fds, Gg, Gll^Fp, Gll^Fp, Gll^Fp, Gs^Fds, Gs^Fms, Gs^Fds, Gs^Fms, Re, Gs^Edt, Re^Edt, Gs, Gs, Ww, Gs, Re, Ce, Re^Edt, Gs^Fds, Ww, Ww, Ww, Ww, Ww, Gll^Fp, Ss, Ww^Ewl, Ss, Gll^Fmf, Gll^Fp, Gs^Es
Gs^Fms, Gll^Fp, Gs^Fms, Gs^Fds, Gs^Fds, Gs, Gs^Fds, Gs^Fds, Gll^Fmf, Gs^Fds, Gll^Fp, Gg, Gg, Gs^Fds, Gg, Gll^Fmf, Gs^Fds, Gs^Fds, Gs, Gs, Gs^Fds, Re^Edt, Gs, Gs^Fds, Re, Ww^Bw/, Ww, Re, Gs^Edt, Gs, Ww, Gs^Fds, Gll^Fp, Gs^Fds, Gs^Fds, Ww, Ww, Ss, Ss, Gll^Fmf, Gg^Es, Gs^Fds
Gg, Gll^Fmf, Gs^Fds, Gs^Fms, Gs^Fds, Gs, Gll^Fp, Gll^Fp, Gs^Fds, Gll^Fmf, Gs^Fms, Gs^Fds, Gs^Fds, Gg, Gs^Fds, Gg, Gg, Gs^Fds, Gs, Gs^Fds, Gs^Fms, Gs, Gs^Fds, Gs, Re, Re^Edt, Gs^Edt, Ww, Ww, Ww, Gs, Gll^Fp, Gs, Gs, Gs^Fds, Gll^Fmf, Ww, Ww, Gll^Fp, Ss, Gs^Fms, Gll^Fp
Gg, Gg, Gs^Fds, Gs^Fms, Gs^Fds, Gg, Gs^Fds, Gs^Fds, Gs^Fds, Gs^Fms, Gs^Fds, Gs^Fds, Gll^Fp, Gs^Fms, Gll^Fmf, Gs^Fds, Gs^Fds, Gs, Gs^Fds, Gs^Fds, Gs, Gs, Gs, Gs, Gll^Fp, Re^Edt, Gs^Fms, Gs, Re^Edt, Gs^Edt, Re^Vct, Ce, Ce, Gs, Gs^Fds, Gs^Fds, Gll^Fmf, Ww, Ww, Gll^Fp, Gll^Fmf, Gs^Fds
Gg, Gg, Gs^Eff, Gs^Eff, Gs^Eff, Gg, Gs, Gs^Fds, Gs^Fms, Gs^Fds, Gs^Fds, Gs^Fds, Gs^Fms, Gs^Fds, Gs^Fms, Gs^Vl, Gs, Gs, Gs, Gs^Fds, Gs^Fms, Gs^Fds, Gs^Fds, Gs, Gs, Gs^Vl, Gs, Re, Gs, Re^Vct, Ce, 2 Ke, Re^Vct, Re^Vct, Gs^Fds, Gs^Fms, Gll^Fmf, Ss, Ww, Ss, Ss, Gll^Fp
Gg^Eff, Gg^Eff, Re^Gvs, Re^Gvs, Re^Gvs, Gg^Eff, Gg^Eff, Gg, Gg, Gs^Fms, Gg, Gs^Fms, Gs^Fds, Gg^Em, Gs^Fms, Gs^Fds, Gs, Gs^Fds, Gs^Fds, Gs^Fds, Gs^Fms, Gs^Fds, Gs, Gs, Gs^Fms, Gs, Gs^Fms, Gs, Gs^Fds, Gs, Gs^Edt, Ce, Re^Edt, Re^Ecf, Gs^Edt, Gs^Fds, Gs^Fds, Gll^Fmf, Ss, Ww, Ww, Ss
Gs^Fds, Re^Gvs, Re^Gvs, Re^Gvs, Re^Gvs, Re^Gvs, Re^Gvs, Gg, Gg, Gg, Re, Gg, Gg, Gg, Gg, Gg, Gs, Gs^Fms, Gs^Fds, Gs^Fds, Gs^Fds, Gs^Fds, Gs, Gs^Fms, Gs^Fds, Gs, Gs, Gs, Gs^Fds, Gs^Fds, Gs^Edt, Gs^Edt, Gs^Fms, Gs^Fds, Re^Edt, Ce, Gs^Edt, Gll^Fmf, Gll^Fp, Ss, Ww, Ss
Gs^Fms, Gs^Fms, Gs^Fds, Re^Gvs, Re^Gvs, Gs^Vh, Gg, Gg, Re, Re, Gg, Re, Re, Re, Re, Gg, Gs, Gs^Fds, Gg, Gs^Fms, Gg, Re, Gg, Gs^Fds, Gs^Fds, Gs^Fms, Gs^Fds, Gs, Gs^Fms, Gs, Gs, Gs, Gs^Fms, Gs^Fds, Gs, Re, Gs^Fds, Gs^Fds, Gs^Fds, Gll^Fp, Gll^Fmf, Ww
Gs^Fms, Gs^Fms, Gg, Gs^Fds, Gg, Re^Gvs, Re, Re, Gg, Gg, Gg^Em, Gg, Gs^Fds, Gg, Gg, Re, Re, Re, Re, Gg, Re, Re, Gg, Gs^Fms, Gs^Fms, Gs^Fds, Gs^Fds, Gs^Fds, Gs^Fms, Gll^Fp, Gs^Fds, Gs, Gs, Gs, Gs^Fms, Gs^Fds, Gs^Fds, Gs^Fds, Gs^Fds, Gll^Fmf, Gll^Fmf, Gll^Fmf
Gg, Gg, Gg^Efm, Gg, Re, Re, Gs^Fds, Gs^Fms, Gs^Fms, Gs^Fds, Gs^Fds, Gs^Fds, Gs^Fms, Gs^Fds, Gg^Em, Gg, Gg, Gg, Gg, Re, Gg, Gs, Gg, Gs^Vl, Gs^Fms, Gs^Fds, Gs^Fds, Gs^Fds, Gs^Fds, Gs^Fds, Gll^Fp, Gs^Fds, Gs^Vc, Gs, Gs^Fds, Gs^Fds, Gll^Fp, Gs^Fms, Gll^Fp, Gs^Fms, Gs^Fds, Gs^Fds
Gg, Gg^Efm, Re, Re, Re^Gvs, Gs^Fds, Gs^Fds, Gs^Fds, Gs^Fds, Gs^Fms, Gs^Fms, Gs^Fms, Gs, Gs, Gs^Fds, Gs^Fds, Gs^Fms, Gs^Fds, Gs^Fds, Gs^Fds, Gg, Gs, Gs, Gg, Gs^Fds, Gs^Fds, Gs^Fds, Gs^Fms, Gs^Fds, Gs^Fds, Gs^Fds, Gs^Fms, Gs^Fds, Gs, Gs, Gs^Fds, Gs^Fms, Gll^Fp, Gs^Fms, Gs^Fds, Gs^Fds, Gs^Fds
Re, Re, Re^Gvs, Re^Gvs, Re^Gvs, Gg, Gs, Gg, Gg, Gs^Fds, Gs^Fds, Gs^Fds, Gs, Gs^Fms, Gs^Fms, Gs^Fms, Gs^Fms, Gs^Fms, Gs^Fds, Gg^Em, Gg, Gg, Gs, Gg, Gs^Fms, Gs^Fds, Gs^Fms, Gs^Fms, Gs^Fds, Gs^Fds, Gg, Gs^Fms, Gg, Gg, Gg, Gs^Fms, Gg, Gs^Fds, Gs^Fds, Gs^Fds, Gs^Fms, Gs^Fms
Gg, Gg, Re^Gvs, Re^Gvs, Re^Gvs, Gs^Vh, Gg, Gs, Gg, Gs^Fds, Gg, Gs, Gs^Fds, Gs^Fds, Gs^Fms, Gs^Fms, Gs^Fds, Gs^Fms, Gs^Fms, Gs^Fds, Gg, Gs, Gs, Gg, Gg, Gg, Gg, Gg, Gg^Eff, Gg, Gg^Eff, Gg, Gg, Gg, Gg, Gg, Gg, Gg, Gg, Gs^Fms, Gg, Gll^Fmf
Gg, Gg, Re^Gvs, Re^Gvs, Re^Gvs, Gs^Fds, Gs^Fds, Gs^Fms, Gg, Gs, Gg, Gg, Gg, Gs^Fds, Gg^Efm, Gs^Fds, Gs^Fds, Gs^Fds, Gs^Fds, Gs^Fds, Gs, Gs, Gg, Gs, Gs, Gs, Gs, Gg^Eff, Re^Gvs, Re^Gvs, Re^Gvs, Gg^Eff, Gg, Gg, Co, Co, Co, Gg, Gg, Gg, Gg, Gg
Gg, Gg, Gg^Eff, Re^Gvs, Re^Gvs, Re^Gvs, Gs^Eff, Gs^Fds, Gg, Gs^Efm, Gg, Gs^Fms, Gs^Fds, Gg, Gg, Gg^Efm, Gg, Gg, Gg, Gs, Gs, Gs, Gg, Gs^Fds, Gs^Fms, Gs^Fds, Gs, Gs^Vh, Re^Gvs, Re^Gvs, Gs^Fds, Gg, Gs^Fds, Gg, Co, 1 Ko, Co, Gg, Re^Vct, Gg, Gs^Fds, Gs^Fds
Gg, Gg, Gg, Gg^Eff, Gg, Gs^Eff, Gs, Gs, Re^Gvs, Gg, Gs^Vh, Gs^Fds, Re^Gvs, Gs, Gs, Gg, Gs^Eff, Gs^Eff, Re^Gvs, Gs, Re^Gvs, Gs^Vh, Re^Gvs, Gs^Fds, Gs^Fds, Gs^Fms, Gs^Fds, Re^Gvs, Re^Gvs, Re^Gvs, Re^Gvs, Gs^Fds, Gs^Fds, Gs^Fds, Gs, Co, Gs, Gs, Gg, Gg, Gg, Gs^Fds
Gg, Gg, Gg^Efm, Gg^Efm, Gg, Gg, Gg^Eff, Re^Gvs, Re^Gvs, Re^Gvs, Re^Gvs, Re^Gvs, Re^Gvs, Re^Gvs, Re^Gvs, Gg, Gg, Re^Gvs, Re^Gvs, Re^Gvs, Re^Gvs, Re^Gvs, Re^Gvs, Re^Gvs, Gg, Gg, Gg, Gg, Gs^Fds, Gs^Fds, Gs^Fds, Gs^Fms, Gs^Fds, Gs^Fds, Gs^Fds, Gs, Gs, Re^Vct, Gs, Gg, Gg, Gg
Gg, Gg, Gg, Gg^Efm, Gg, Gg, Gg, Gg^Eff, Gg^Eff, Re^Gvs, Re^Gvs, Re^Gvs, Gg, Re^Gvs, Gg, Gg, Gg, Re^Gvs, Gg, Re^Gvs, Gg, Re^Gvs, Gg, Re^Gvs, Gg^Efm, Gg, Gg, Gg, Gs^Fds, Gs^Fds, Gs^Fms, Gs^Fms, Gs^Fms, Gs^Fms, Gs^Fms, Gs^Fms, Gs^Fms, Gs, Gs, Gs, Gg, Gg
Gg, Gg, Gg, Gg, Gg, Gg, Gg, Gg, Gg, Gg^Eff, Gg, Gg, Gg, Gg, Gg, Gg, Gg, Gg, Gg, Gg, Gg, Gg, Gg, Gg, Gg, Gg, Gg, Gs^Fds, Gs^Fds, Gs^Fds, Gg, Gs^Fds, Gs^Fds, Gs^Fds, Gs^Fds, Gs^Fds, Gg, Gs^Fds, Gg, Gs, Gg, Gg
