Hh^Fp, Hh^Fp, Hh^Fp, Hh, Hh, Hh, Hh, Hhd, Hhd, Gg, Hh, Gg, Gg, Gg, Rp, Gg, Gs^Fds, Gs^Fms, Gs^Fms, Gs^Fds, Gs^Fds, Gs^Fds, Gs^Fds, Gs^Fds, Gs^Fds, Gg, Gg^Efm, Gg, Gg, Gg, Gs^Fds, Gs^Fds, Gs^Fms, Gs^Fds, Gs^Fds, Gg, Gg, Ww, Wo, Ww, Gg, Gg, Gg^Eff, Re^Eff, Re^Gvs, Re^Gvs, Re^Gvs, Re^Gvs, Re^Gvs, Re^Gvs, Re^Gvs, Gg, Gg, Gg, Re, Re, Gg, Gg
Hhd, Hh^Fp, Hh^Fp, Hh, Gs^Es, Hh, Hh, Hh, Hh, Hh, Hh, Gg, Gg, Gg, Gg, Rp, Gs^Fms, Gs^Fms, Gs^Fds, Gs^Fds, Gs^Fms, Gs^Emf, Gs^Em, Gs^Fms, Re, Gs, Gs^Efm, Gs^Efm, Re, Re, Re, Gs^Fms, Gs^Em, Gs^Fms, Gs^Fds, Gg, Gg, Ww, Wo, Wo, Ww, Gg, Re^Gvs, Re^Gvs, Re^Gvs, Re^Gvs, Re^Gvs, Re^Gvs, Re^Gvs, Re^Gvs, Re^Gvs, Gs, Gs^Eff, Gg, Re, Gg, Gg, Gg
Hhd, Hhd, Hhd, Hh, Hh, Gs^Es, Gs, Gs, Gs, Gg^Es, Gg, Hh, Gg, Gg, Gg, Rp, Rp, Gs^Fds, Gs^Em, Gs^Fms, Gs^Fms, Gs^Fms, Re, Re, Re^Vct, Re, Gs, Re, Re^Vct, Re^Vct, Re, Gs^Fds, Re, Gs^Fds, Re, Gs, Re, Gg, Gg, Wo, Ww, Gg, Gg^Eff, Re^Gvs, Gs^Vh, Re^Gvs, Re, Re^Gvs, Re, Re^Gvs, Re, Gs^Eff, Re, Re, Re^Gvs, Gs^Wm, Re^Gvs, Gg
Hh^Fp, Hhd, Hhd, Hh^Fp, Hh, Hh, Gg, Gs, Re, Gs, Gs, Gg, Gg, Gg, Gg, Gg, Rp, Gs^Fds, Re^Vct, Gs^Fds, Gs^Fds, Gs^Fms, Re, Re^Vct, Rb^Ecf, Re, Re^Edt, Re^Edt, Rb, Rb^Ecf, Re^Vct, Re, Ce, Re, Ce, Re, Ce, Re, Gg, Wo, Ww, Gg, Gg, Gg^Eff, Gg, Re, Gs^Fds, Re, Gs^Fds, Re, Gs, Re, Re^Gvs, Re^Gvs, Re^Gvs, Re^Gvs, Re^Gvs, Re^Gvs
Hh^Fp, Hh^Fp, Hhd, Hh, Gs^Es, Hh, Gg, Re, Re^Ecf, Re, Re, Re, Re, Gs, Gs, Gs, Rp, Re, Re^Edt, Re^Edt, Re^Edt, Re, Re^Vct, Re, Rb, Rb, Re^Vct, Rb^Edt, Re, Re^Vct, Re^Edt, Rb, Ce, Ce, 4 Ke, Ce, Ce, Re, Wo, Ww, Ww^Ewl, Gg, Gs^Fds, Gg, Gs^Em, Gs^Fds, Gs^Fms, Gs^Fds, Gs^Fds, Gs, Gs, Re, Re^Gvs, Re^Gvs, Re^Gvs, Re^Gvs, Re^Gvs, Re^Gvs
Hh, Hh, Gs, Hh, Hh, Gs, Gs, Re, Re, Re, Re^Vct, Re^Vct, Re, Re, Re, Re, Re^Vct, Rp, Rb^Ecf, Rb, Rb, Re^Vct, Re^Edt, Re^Edt, Re^Edt, Re^Vct, Re, Re, Gs, Re^Edt, Gs, Re, Ce, Ce, Ce, Ce, Ce, Re, Wo, Ww, Gg, Gg, Gs^Fds, Gs^Fds, Gs^Fds, Gs^Fds, Gs^Fds, Gs^Fds, Gs^Fms, Gs^Fms, Gg, Re, Gs^Vh, Re^Gvs, Re^Gvs, Re^Gvs, Re^Gvs, Re^Gvs
Gg, Hh, Gs^Es, Hh, Hh, Hh, Gs, Gs, Gd, Re, Re, Rb, Rb, Gs, Re^Edt, Re^Vct, Re, Rp, Re, Re, Re^Vct, Re, Gs, Re, Gs, Re, Gd, Gd, Gg, Gs, Gs, Re, Re, Re, Re, Re, Re, Re, Ww, Ww, Gg, Gg, Re, Gs^Fds, Gs^Fds, Gs^Fms, Gs^Fds, Gs^Fms, Re, Re, Re, Re, Gg, Gg, Gg, Gg, Gg, Gg
Hh, Gg, Gg, Gg, Gs, Gs, Re, Gd, Gd, Re, Re, Rb, Ce, Re, Re^Edt, Re^Edt, Gs, Rp, Rp, Re^Vct, Re, Re, Gd, Gd^Wm, Gs, Gd, Gd, Gs, Gs, Gs, Re^Gvs, Gs, Gs, Gs, Gs, Gs, Gs, Gs, Gs, Ww, Ww^Bw/, Re, Gg, Re, Re, Re, Re, Gs^Fms, Re, Gg, Ww^Bw|, Gg, Ww, Gg, Ww, Gg, Ww, Gg
Hh, Gg, Gg, Gg, Re, Re, Re^Vct, Re, Re, Re, Ce, 3 Ke, Ce, Ce, Ce, Re, Gd, Gd, Gs, Rp, Rp, Gd, Gd, Gd, Gd, Gd, Re^Gvs, Re^Gvs, Re^Gvs, Re^Gvs, Re^Gvs, Re^Gvs, Re^Gvs, Gd^Wm, Gs, Gs, Re, Gs, Re, Re, Ww, Gg, Ww, Gg, Gg, Gg, Gg, Re, Ww, Ww, Gg, Ww, Gs^Fds, Ww, Gs^Fds, Ww, Gs^Fms, Ww
Hh, Gg, Gg, Gg, Re, Re^Vct, Rb, Rb^Edt, Re, Ce, Ce, Ce, Ce, Ce, Re, Re, Gd, Gd, Re^Eff, Re, Re, Rp, Rp, Gd, Gs, Re^Gvs, Re^Gvs, Re^Gvs, Re^Gvs, Re^Gvs, Re^Gvs, Re^Gvs, Re^Gvs, Re^Gvs, Re^Gvs, Gs, Re, Re, Gg, Gg, Gg, Ww, Gs^Fds, Ww, Ww, Ww, Ww, Ww, Gg, Gg, Gs, Gg, Gs^Fms, Gs^Fds, Gs^Fms, Gs^Efm, Gs^Fp, Gs^Fds
Gg, Gg, Gg, Gs, Gs, Re, Rb, Rb^Edt, Re, Re, Re, Ce, Re, Re, Gs, Gs, Re^Eff, Re^Eff, Re^Gvs, Re^Eff, Re^Eff, Re, Rp, Gs, Gs^Vh, Re^Gvs, Re^Gvs, Re^Gvs, Re^Gvs, Re^Gvs, Re^Gvs, Re^Gvs, Re^Gvs, Re^Gvs, Re^Gvs, Re, Gs^Fds, Gs^Fds, Gs^Fp, Gg, Ww^Ewl, Ww, Gs^Fp, Gs^Fp, Gg, Gg, Gg, Gg, Gs^Fds, Gs, Gs^Fms, Gs^Fds, Gs^Es, Gs^Fp, Gs^Fds, Gs^Em, Gs^Fds, Gs^Fms
Gg, Gg, Gg, Gg, Gs, Re, Re^Vct, Re^Vct, Re^Edt, Gs, Gd, Re, Gs, Gs, Re^Eff, Re^Eff, Re^Gvs, Re^Gvs, Re^Gvs, Re^Gvs, Re^Gvs, Re, Rp, Gs, Re^Eff, Re^Gvs, Re^Gvs, Re^Gvs, Re^Gvs, Re^Gvs, Re^Gvs, Re^Gvs, Re^Gvs, Re^Gvs, Re, Re, Gs, Gs^Fms, Gs^Fms, Gg, Gg, Ww, Gg, Gg, Gg, Gs^Fds, Gs^Fds, Gs^Fds, Gg, Gs, Gs, Gs^Fms, Gs^Fds, Gs^Fds, Gs^Fds, Gs^Fds, Gs^Fds, Gs^Fds
Hh, Hh, Hh, Hh, Gg, Re, Re, Re^Edt, Re^Edt, Gd, Gd, Gd, Gs^Vh, Re^Eff, Re^Gvs, Re^Gvs, Re^Gvs, Re^Gvs, Re^Gvs, Re^Gvs, Re^Gvs, Re^Gvs, Re, Rp, Rp, Re^Eff, Re^Eff, Re^Gvs, Re^Gvs, Re^Gvs, Re, Re^Gvs, Re^Vh, Re, Gs^Fms, Gs, Gg, Gg, Gg, Gg, Gg, Ww, Ww, Gg, Gg, Gs^Fp, Gs^Fds, Gs^Fds, Gs^Fds, Gs^Fms, Gs, Gg, Gg, Gs^Emf, Gs^Fms, Gs^Fds, Gs^Fds, Gs^Fds
Hh, Hh, Hh, Hh, Hh, Gg, Gs, Re, Re, Gs, Gd, Gd, Re, Re, Re^Gvs, Re^Gvs, Re^Gvs, Re^Gvs, Re^Gvs, Re^Gvs, Re^Gvs, Re^Gvs, Re, Re, Re, Rp, Re, Re^Eff, Re, Re, Re^Gvs, Re, Re^Gvs, Re, Re^Gvs, Gs, Gs^Wm, Gs, Gg, Gg, Gg, Gg, Ww^Ewl, Ww, Ww, Gs^Fds, Ww, Gs^Fds, Ww, Gs^Fds, Ww^Bw|, Gs^Fds, Gs^Fms, Gs^Em, Gs^Fms, Gs^Fds, Gs^Fds, Gs^Fms
Hh, Hh, Gg, Hh, Gs, Gg, Gs, Re^Ecf, Re^Edt, Re, Re, Gs, Re, Re^Gvs, Re^Gvs, Re^Gvs, Re^Gvs, Re^Gvs, Re^Gvs, Re^Gvs, Re^Gvs, Re^Gvs, Re, Re, Re^Eff, Rp, Rp, Re, Re, Re^Gvs, Re^Gvs, Re^Gvs, Re^Gvs, Re^Gvs, Re^Gvs, Re^Gvs, Re^Gvs, Gs, Gs^Fds, Gs^Fds, Gs^Fds, Gg, Gg, Gg, Gg, Ww, Gs^Fp, Ww, Gs^Fms, Ww, Gg, Ww, Ww, Gs^Fds, Gs^Fds, Gs^Fds, Gs^Fds, Gs^Fds
Hh, Gg, Gg, Gs, Re, Gs, Re, Re^Edt, Re^Edt, Re^Vct, Re, Re^Edt, Re^Edt, Re^Gvs, Re^Gvs, Re^Gvs, Re^Gvs, Re^Gvs, Re^Gvs, Re^Gvs, Re^Vh, Re, Re^Gvs, Re^Gvs, Re^Gvs, Re^Eff, Re^Eff, Rp, Rp, Re^Gvs, Re^Gvs, Re^Gvs, Re^Gvs, Re^Gvs, Re^Gvs, Re^Gvs, Re^Gvs, Re^Gvs, Gs, Gs, Gs, Gs, Gg, Gg, Gg, Gs^Fp, Gg, Gs^Fds, Gg, Gg, Gg, Gs^Fp, Gs^Fms, Ww, Ww, Gs^Fds, Gs^Fds, Gs^Fms
Gg, Gg, Gg, Gs, Re^Vct, Re^Vct, Gs, Gs, Gs, Re, Gs, Gs, Re, Re, Re, Re^Gvs, Re, Re, Re, Re, Re^Gvs, Re^Gvs, Re^Gvs, Re^Gvs, Re^Gvs, Re^Gvs, Re^Gvs, Re, Rp, Re, Re^Eff, Re^Gvs, Re^Gvs, Re^Gvs, Re^Gvs, Re^Gvs, Re^Eff, Re^Eff, Re^Gvs, Re^Gvs, Re^Gvs, Gs, Gs^Fds, Gs^Fds, Gs^Efm, Gg, Gs^Em, Gg, Gg, Gs^Fms, Gs^Fms, Gs^Fds, Gs^Fms, Gs^Fp, Ww, Gs^Fds, Gs^Fds, Gs^Fms
Gg, Gg, Gg, Re, Re, Re, Re, Gs, Re^Vct, Re, Re^Ecf, Re, Re^Vct, Re, Gs, Re, Gd^Wm, Gs, Re, Re^Gvs, Re^Gvs, Re^Gvs, Re^Gvs, Re^Gvs, Re^Gvs, Re^Gvs, Re^Gvs, Re, Gs, Rp, Rp, Re^Eff, Re^Eff, Re^Gvs, Re^Eff, Re^Eff, Re, Re^Vh, Re^Gvs, Re^Gvs, Re^Gvs, Re^Gvs, Re^Gvs, Gs^Fds, Gs^Fms, Gs^Fds, Gs^Fds, Gg, Gg, Gs^Fds, Gs^Fds, Gs^Fds, Gs^Fds, Gs^Fds, Hh, Ww, Ww, Hh
Gg, Gg, Gg, Gg, Re, Gs, Gs, Re^Vct, Gs, Re, Re^Edt, Re^Vct, Re, Re, Gs^Eff, Gs, Gs, Gs, Re, Re^Gvs, Re^Gvs, Re^Gvs, Re^Gvs, Re^Gvs, Re^Gvs, Re^Gvs, Gs, Gs, Gs^Fds, Re, Re, Rp, Rp, Re, Rp, Re, Rp, Re, Re^Gvs, Re^Gvs, Re^Gvs, Re^Gvs, Re^Gvs, Gs^Em, Gs^Fds, Gs^Fds, Gs^Fms, Gs^Fms, Gg, Gs^Fms, Gg, Gg, Gs, Hh, Hh, Hh, Ww, Hh
Gg, Gg, Gs, Gs, Re, Re^Edt, Re, Gs, Re, Re^Edt, Re^Edt, Re, Gs, Gs^Eff, Re^Gvs, Re^Gvs, Re^Gvs, Re^Gvs, Re^Gvs, Re, Re, Re^Gvs, Re^Gvs, Re^Gvs, Re^Gvs, Re^Gvs, Gs, Gs^Fds, Gs^Fms, Re, Gg, Gs, Gs, Rp, Gg, Rp, Gg, Rp, Rp, Re^Gvs, Re^Gvs, Re^Gvs, Gg, Gg, Gg, Gg, Gg, Gg, Gg, Gg, Gs, Gs, Hh, Gs^Es, Hh, Hh, Hh, Hh
Gs^Fms, Gs^Fms, Gs^Fms, Re, Re^Vct, Re^Vct, Re^Edt, Re^Ecf, Re^Vct, Re^Vct, Re, Gs, Re^Gvs, Re^Gvs, Re^Gvs, Re^Gvs, Re^Gvs, Re^Gvs, Re^Gvs, Re^Gvs, Re^Gvs, Re, Re^Vh, Re^Gvs, Gs, Gs, Gs^Fds, Gs^Fds, Gs^Fms, Gs^Fds, Gg, Gs, Gg, Gg, Gg, Gg, Gs, Gg, Gg, Rp, Rp, Gs, Gs, Gg, Gg, Gg, Re, Gg, Gg, Gs, Hh, Gs^Es, Hh, Gd^Es, Gd^Es, Hh, Hh, Hh
Gs^Fms, Gs^Fp, Gs^Fp, Re, Re, Re^Edt, Ce, Re, Ce, Re, Re^Edt, Gs, Re^Gvs, Re^Gvs, Re^Gvs, Re^Gvs, Re^Gvs, Re^Gvs, Re^Gvs, Re^Gvs, Re^Gvs, Re, Re, Re, Re, Gs, Gs^Fds, Gs^Em, Gs, Gs, Gg, Gg, Gg, Gg, Gg, Gg, Gs, Hhd, Gg, Gg, Rp, Gs, Gs, Gg, Re, Re, Ce, Re, Re, Gs^Es, Gs, Hh, Hh, Hh, Hhd, Hhd, Hhd, Hhd
Gs^Fms, Gll^Emf, Gs^Fp, Gs^Fp, Re, Ce, Ce, Ce, Ce, Ce, Re^Edt, Gs, Re^Gvs, Re^Gvs, Re^Gvs, Re^Gvs, Re^Gvs, Re^Gvs, Re^Gvs, Re^Gvs, Re^Gvs, Re^Gvs, Re^Gvs, Re^Gvs, Re^Gvs, Re, Gg, Gg, Gg, Gg, Gg^Es, Hh, Gg, Gg, Gg, Gg, Hh, Hhd, Gg, Gg, Gg, Rp, Rp, Re, Ce, Ce, Ce, Ce, Re^Edt, Re^Edt, Re, Hh, Hh, Hh, Hh, Hhd, Hh, Hhd
Gll^Es, Gs^Fms, Gs^Fp, Gs^Fp, Re, Ce, Ce, 2 Ke, Ce, Ce, Re, Gs, Gs^Eff, Re^Gvs, Re^Gvs, Re^Gvs, Re^Gvs, Re, Re^Gvs, Re^Gvs, Re^Gvs, Re^Gvs, Re^Gvs, Re^Gvs, Re^Gvs, Re, Gg, Gs^Fds, Gg, Gg, Hh, Hh, Gs, Gg, Gg, Gg, Gs, Gs^Es, Gg, Gg, Re, Re, Re, Rp, Re, Ce, Re, Re, Ce, Ce, Ce, Re, Gs, Hh, Hh, Hh, Hh, Hh
Gs^Fp, Gs^Fp, Gs^Fp, Gs^Fms, Re, Ce, Ce, Ce, Ce, Ce, Re, Gg, Gs, Gs^Eff, Gs, Re, Re^Gvs, Re^Gvs, Re^Gvs, Re^Gvs, Re^Gvs, Re^Gvs, Re^Gvs, Re^Gvs, Re, Re, Gg, Gg, Gg, Gg, Gg, Gs, Gg, Gg, Gg, Gg, Gg, Gg, Re, Re, Ce, Ce, Ce, Rp, Rp, Re, Ce, Ce, Ce, Ke, Ce, Re, Gs, Gs, Hh, Hh, Hh, Hh
Gs^Fp, Gs^Fp, Gs^Fp, Gs^Fms, Gs^Fp, Re, Re, Re, Re, Re, Gg, Gg, Gs, Gs, Gg, Re, Gs^Eff, Re^Gvs, Re^Gvs, Re^Gvs, Re^Gvs, Re^Gvs, Re, Re, Gg, Gg, Gg, Gg, Gs, Gg, Gg, Gg, Gg, Gg, Gg, Hh, Gg, Gg, Re, Ce, Ce, Ce, Re, Re, Ce, Rp, Re, Ce^Ecf, Ce, Ce, Re^Edt, Re, Re, Gs, Gs, Gd^Es, Gd^Es, Gs^Es
Gs^Fp, Gs^Fp, Gs^Fp, Gs^Fp, Gs^Fms, Gs^Fms, Gs^Fp, Gs^Fp, Gg, Gg, Gg, Gg, Gg, Gg, Gg, Gg, Gs, Gs^Eff, Gs^Eff, Re^Gvs, Re^Vh, Re, Gs, Gs, Hh, Hh, Gs, Gs, Gg, Gg, Gg, Gg, Gg, Gg^Es, Hhd, Hhd, Gg, Gg, Gg, Re, Re, Re, Ce, Ce, Ce^Ecf, Rp, Rp, Ce, Re, Re^Edt, Re^Edt, Re^Vct, Re^Vct, Re, Gs, Gd^Es, Hhd, Hhd
Gs^Fp, Gs^Fp, Gs^Es, Gs^Fp, Gs^Fms, Gs^Fp, Gg, Gg, Gg, Gg, Hh, Hh, Gg, Gg, Gg, Gg, Gg, Gg, Gg, Gs, Gg, Gg, Gs, Gs, Hh, Gs^Es, Gs, Gg, Gg, Hh, Gg, Gg, Gs, Gg^Es, Hhd, Gs, Gg, Gg, Gg, Gg, Re, Ce, 1 Ke, Ce, Ce, Ce, Re^Edt, Rp, Rp, Re^Vct, Re^Vct, Re^Ecf, Re, Re, Gs, Hh, Hh, Hh
Gs^Fms, Gs^Fms, Gs^Fp, Gs^Fp, Gs^Fp, Gs^Fms, Gs^Fp, Gg, Gs, Hh, Hh, Hh, Gg, Gg, Gg, Gg, Gg, Gg, Gg, Gs, Gg, Gg, Gg, Hh, Gg^Es, Gs^Es, Gs, Hh, Hhd, Hhd, Gs^Es, Gg, Gs, Hh, Gs, Gs, Gg, Gg, Gs, Gg, Re, Ce, Ce, Ce, Re, Re^Edt, Re^Edt, Re^Vct, Re^Vct, Rp, Re, Re, Gg, Gg, Gs, Hh, Gs^Es, Hh
Gs^Fp, Gs^Fp, Gll^Em, Gs^Fms, Gs^Fp, Gs^Fp, Gs^Fp, Gs, Hh, Hh, Gs, Hh, Gs, Gs, Hh, Gg, Gs, Gg, Gs^Fms, Gg, Gg, Gg, Gg, Gg, Gs, Gs, Hh, Hh, Gs^Fms, Hhd, Gs^Es, Gg, Gg, Hh, Hh, Gs, Gs^Es, Gs, Hh, Gs, Gs, Re, Re, Re, Re, Re^Vct, Re^Vct, Re^Ecf, Re, Rp, Re^Vct, Re, Re, Gg, Gg, Gs, Gg, Gg
Gs^Fms, Gs^Fp, Gs^Fp, Gll^Es, Gs^Fms, Gs^Fp, Gs^Fp, Gs^Fms, Gs^Vl, Gs, Gs, Gs, Hh, Gs, Hh, Gs, Hh, Gs^Fms, Gs^Fp, Gg, Gg, Gg, Hh, Gg, Gg, Gg, Hh, Gs^Fp, Gs^Fms, Gs^Fp, Gg, Gg, Gg, Gg, Hh, Gs^Es, Hhd, Gs^Es, Hh, Gs, Gs, Gs, Gs, Re^Vct, Re^Vct, Re^Ecf, Gs, Re, Gs, Rp, Rp, Re^Vct, Re^Edt, Gg, Gg, Gs^Fms, Gs^Fms, Gs^Fds
Gs^Fms, Gs^Fp, Gs^Fp, Gs^Fp, Hh^Fp, Gs^Fp, Hh, Gs^Fp, Gs, Gs, Hh, Hh, Hh, Hh, Hh, Hh, Gs^Fp, Gll^Emf, Gll^Em, Gs^Fms, Gg, Hh, Gg, Gg, Gg, Gll^Em, Gll^Fp, Gs^Fms, Gs^Fp, Gg^Vl, Gg, Gg, Gs^Fp, Gs^Fms, Gs^Fms, Hh, Hhd, Hhd, Hh, Hh, Gs^Es, Gs, Gs, Re, Re, Re, Gg, Gs, Gg, Gs, Re^Ecf, Rp, Re^Vct, Re^Edt, Gg, Gs^Fds, Gs^Fds, Gs^Fds
Gs^Fp, Gs^Es, Gs^Fp, Hh^Fp, Hh, Hh, Hh, Gs, Gs, Gs, Gs, Hh, Hh, Hh, Hh, Hh, Hh^Fp, Gs^Fp, Gs^Fms, Gg, Hh, Hh, Gg, Gg, Gs^Fp, Gs^Fp, Gs^Fms, Gs^Fp, Gs^Fp, Gs^Fp, Gg, Gg, Hh, Gs^Fp, Hh^Fp, Hh, Hhd, Hhd, Hh, Hh, Hhd, Gs^Es, Gs, Gg, Gg, Gg, Gg, Gg, Gg, Re^Vct, Re^Vct, Rp, Rp, Re^Edt, Gg, Gg, Gs^Fms, Gs^Fds
Hh, Gs^Fp, Hh^Fp, Hh^Fp, Hh, Hh, Hh^Fp, Hh, Hh^Fp, Hh, Hh, Hh, Hh^Fp, Hh, Hh, Hh, Hh, Hh^Fp, Hh, Hh, Hhd, Hh, Gs^Fp, Gs^Fp, Gll^Em, Gll^Es, Gs^Fms, Gs^Fp, Gs^Fms, Gs^Fp, Hh^Fp, Hh, Hh, Gs^Fp, Hh, Hhd, Hh, Hh, Hh, Hhd, Hhd, Gs^Es, Hh, Gg^Es, Hh, Gg, Gs^Fms, Gg, Gg, Gg, Gg, Re^Edt, Re^Edt, Rp, Re, Gg, Gg, Gg
Gg, Hh, Hh, Hh, Hh, Hh^Fp, Gg^Fp, Hh^Fp, Gg, Hh^Fp, Gg^Fp, Hh^Fp, Gg, Hh, Gg, Hh, Hh, Hhd, Hhd, Hhd, Hhd, Gs^Fp, Gg, Gs^Es, Gg, Gs^Fp, Hh, Gs^Fp, Gg, Gs^Fms, Hh, Hh, Hh, Hh, Hh, Hh, Gg, Hh, Gg, Hhd, Gg, Hh, Gg, Hh, Gg, Gs^Fds, Gs^Fds, Gs^Fds, Gg, Gg, Gg, Gg, Re, Rp, Gg, Gg, Gg, Gg
