Xu, Xu, Xu, Xu, Xu, Xu, Xu, Xu, Xu, Xu, Xu, Xu, Xu, Xu, Xu, Xu, Xu, Xu, Xu, Xu, Xu, Xu, Xu, Xu, Xu, Xu, Xom, Xom, Uu, Rr, Uu
Xu, Xu, Xu, Xu, Xu, Xu, Xu, Xu, Xu, Xu, Xu, Xu, Xu, Xu, Xu, Xu, Xu, Xu, Xu, Xu, Xu, Xu, Xu, Xu, Xom, Xom, Uu, Uu, Rr, Rr, Uu
Xu, Xu, Xu, Xu, Xu, Xu, Xu, Xu, Xu, Xu, Xu, Xu, Xu, Xu, Xu, Xu, Xu, Xu, Xu, Xu, Xu, Xu, Xu, Xu, Xom, Uu, Co, Co, Co, Uu, Xom
Xu, Xu, Xu, Xu, Xu, Xu, Xu, Xu, Xu, Xu, Xu, Xu, Uu^Vu, Xu, Xu, Xu, Uu^Vu, Xu, Xu, Xu, Xu, Xu, Xu, Xu, Xom, Uu, Co, 1 Ko, Co, Uu, Xom
Xu, Xu, Xu, Xu, Xu, Xu, 2 Kte, Cte, Cte, Xu, Xu, Uu, Uu, Xu, Xu, Uu, Xu, Xu, Xu, Xu, Xu, Xu, Xom, Xom, Uu, Uu, Rr^Es, Co, Uu, Uu, Xom
Xu, Xu, Xu, Xu, Xu, Cte, Cte, Cte, Cte, Xu, Xu, Xu, Uu, Xu, Xu, Uu, Xu, Xu, Xu, Xu, Xu, Xu, Xom^Efs, Uu, Rr, Rr^Edb, Uh, Uu, Xom, Xom, Xu
Xu, Xu, Xu, Xu, Xu, Cte, Cte, Cte, Cte, Uu, Rb^Edb, Xu, Uu^Edb, Xu, Uu, Uh, Uu, Xu, Xu, Xu, Xuc, Xom, Uu, Uu, Rr^Es, Uh, Xom, Xom, Xu, Xu, Xu
Xu, Xu, Xu, Uu^Vu, Uu, Xu, Uu, Cte, Rb, Rb^Edb, Uu, Rb^Edb, Rb, Rb^Edb, Rb^Edb, Uh, Rb, Rb, Rb^Dr, Xuc, Uh, Uh, Rr, Rr^Es, Uu, Uu, Xom, Xu, Xu, Xu, Xu
Xu, Xu, Xu, Xu, Xu, Uu, Uu, Uu, Uu, Uu, Uu, Xu, Xu, Xu, Uu, Uu, Xu, Uu, Xuc, Rb, Uu, Rr, Uh, Uu, Xom, Xom, Xu, Xu, Xu, Xu, Xu
Xu, Xu, Uu^Vu, Xu, Rb^Edb, Rb^Edb, Xu, Xu, Uh, Xu, Xu, Xu, Xu, Uu, Xu, Xu, Xu, Xuc, Uu, Uu, Rr, Rr, Uh, Xuc, Xu, Xu, Xu, Xu, Xu, Xu, Xu
Xu, Xu, Xu, Uu, Rb^Edb, Uu, Xu, Xu, Uu^Edb, Xu, Xu, Xu, Uu, Uh, Uu, Xu, Xom^Efs, Xom, Chr, Rr^Es, Uu, Uu, Xuc, Uu, Rb, Xu, Xu, Xu, Xu, Xu, Xu
Xu, Xu, Xu, Uu^Edb, Uh^Edb, Xu, Xu, Xu, Uu, Rb^Edb, Uu, Xu, Uu, Xu, Xu, Uu, Uh, Uh, Rr^Edb, Khr, Chr, Xuc, Xu, Uu, Uu, Rb, Uu, Xu, Uu^Vu, Xu, Xu
Xu, Xu, Uu^Vu, Uh^Edb, Uu^Edb, Xu, Xu, Xu, Xu, Rb^Edb, Rb, Uu^Vu, Xu, Xu, Xuc, Xom, Uu, Rr, Uu, Uu, Xom, Xom, Xu, Xu, Rb, Rb, Uh, Uu, Xu, Xu, Xu
Xu, Xu, Xu, Uu^Edb, Rb, Xu, Uu, Uu, Uu, Uu^Edb, Rb^Edb, Uu, Rb, Xuc, Uu, Uu, Rr, Rr^Es, Uh, Uu, Uu, Xu, Uh, Uu, Xu, Xu, Uu^Edb, Uu, Xu, Xu, Xu
Xu, Xu, Xu, Xu, Uu, Rb, Xu, Xu, Xu, Xu, Xu, Uu, Xuc, Uh^Dr, Uu, Rr, Uu, Uh, Xom, Xom, Uu, Xu, Uu, Xu, Xu, Xu, Rb^Edb, Uu^Edb, Uu, Xu, Xu
Xu, Xu, Xu, Uu, Xu, Rb^Edb, Uu^Edb, Xu, Xu, Xu, Xu, Xom^Efs, Uu, Uh, Rr, Rr^Es, Uu, Xuc, Uu, Xu, Uu, Uu, Xu, Xu, Xu, Xu, Rb^Edb, Uu, Xu, Uu^Vu, Xu
Xu, Xu, Xu, Uu^Vu, Xu, Uu, Uh^Edb, Uu, Uu, Uu, Uu, Uu, Uu, Rr, Uu, Uu, Xuc, Uu^Dr, Uu^Vu, Xu, Uu, Xu, Xu, Xu, Xu, Xu, Rb^Edb, Xu, Xu, Xu, Xu
Xu, Xu, Xu, Xu, Xu, Xu, Uu^Edb, Rb^Edb, Xu, Xu, Xom, Xom, Uu, Rr^Edb, Uu, Xom, Xu, Uu, Uu, Rb, Rb^Edb, Xu, Xu, Xu, Tb, Uu^Edb, Uu, Xu, Xu, Xu, Xu
Xu, Xu, Xu, Xu, Uu, Uu, Uu^Edb, Rb^Edb, Xu, Xu, Xuc, Uu, Khr, Rr, Uu, Uu, Uh, Uh, Xu, Uu, Uu^Edb, Uu^Edb, Uh^Edb, Xu, Rb, Rb, Xu, Uu, Uu^Vu, Xu, Xu
Xu, Xu, Xu, Xu, Uu^Vu, Xu, Xu, Rb, Uu, Xu, Xuc, Chr, Rr^Edb, Chr, Xom, Xom, Xu, Xu, Uu, Uu, Xu, Uu, Uh, Uu^Edb, Rb, Uu, Xu, Xu, Xu, Xu, Xu
Xu, Xu, Xu, Xu, Xu, Xu, Uu, Uh, Rb, Uu, Uh, Uu, Rr, Uu, Xom, Xu, Xu, Xu, Uh, Xu, Xu, Uu^Vu, Uu, Uu^Edb, Uu^Emf, Xu, Xu, Xu, Xu, Xu, Xu
Xu, Xu, Xu, Xu, Xu, Uu, Xu, Xu, Uu, Rb, Uh, Rr, Uu, Uu, Xom, Xu, Xu, Xu, Xu, Uu, Xu, Xu, Xu, Uu^Edb, Uu^Edb, Xu, Tb^Tf, Xu, Xu, Xu, Xu
Xu, Xu, Xu, Xu, Xu, Uu, Xu, Xu, Uu, Rb, Uu, Rr^Es, Uu, Xom, Xu, Xu, Xu, Xu, Uu, Uu, Uu, Uu, Uu^Emf, Rb, Rb^Edb, Uu^Emf, Xu, Uu^Vu, Xu, Xu, Xu
Xu, Xu, Xu, Xu, Xu, Uu^Vu, Uu, Xu, Xom, Xuc^Efs, Uu, Rr^Edb, Uh, Xom, Xu, Uu^Vu, Xu, Xu, Uu, Xu, Xu, Xu, Xu, Uu, Ce, Uu, Xu, Xu, Rb^Emf, Xu, Xu
Xu, Xu, Xu, Xu, Xu, Xu, Rb, Xu, Xom, Uu, Rr^Edb, Rr, Uh, Xuc, Xu, Uu, Xu, Xu, Uu, Xu, Xu, Rb^Gvs, Rb^Gvs, Ce, Rb^Edb, Ce^Vc, Rb^Em, Rb^Emf, Rb^Emf, Rb^Emf, Xu
Xu, Xu, Xu, Xu, Xu, Xu, Rb, Xu, Xuc, Uu, Rr, Uu, Uu, Xuc, Uu, Uu, Uh, Xu, Uu, Xu, Uu, Xu, Xu, Uu, Rb, Uu, Uu^Vu, Rb^Emf, Wwg, Tb, Xu
Xu, Xu, Xu, Xu, Xu, Xu, Xu, Uh, Uu, Uu, Rr^Es, Uu, Uu, Rb^Dr, Rb, Rb, Uu, Uh, Rb, Rb, Rb, Uu, Cte, Cte, Cte, Xu, Xu, Wwg, Tb^Tf, Tb^Tf, Xu
Xu, Xu, Xu, Xu, Xu, Xu, Xu, Xuc, Uu, Rr^Edb, Uh, Uh, Xuc, Uu, Xu, Uu, Xu, Uu, Xu, Uu, Xu, Uu, Cte, Cte, Cte^Eff, Cte^Eff, Cte^Eff, Xu, Xu, Xu, Xu
Xu, Xu, Xu, Xu, Xu, Xu, Xu, Xuc, Uu, Rr^Es, Uu, Xom^Efs, Xom, Xu, Xu, Uu, Xu, Xu, Xu, Uu, Xu, Xu, Cte, Cte^Eff, Cte^Eff, 3 Cte^Kov, Cte^Eff, Xu^Eff, Xu, Xu, Xu
Xu, Xu, Xu, Xu, Xu, Xu, Xu, Xom, Uu, Rr, Rr^Edb, Uu, Xom, Xu, Xu, Uu^Vu, Xu, Xu, Xu, Uu^Vu, Xu, Xu, Xu, Cte, Xu, Cte^Eff, Xu, Xu, Xu, Xu, Xu
Xu, Xu, Xu, Xu, Xu, Xu, Xu, Xom, Xom, Uu, Rr^Es, Uu, Xom, Xu, Xu, Xu, Xu, Xu, Xu, Xu, Xu, Xu, Xu, Xu, Xu, Xu, Xu, Xu, Xu, Xu, Xu
Xu, Xu, Xu, Xu, Xu, Xu, Xu, Xu, Xom, Uu, Rr, Uu, Xom, Xu, Xu, Xu, Xu, Xu, Xu, Xu, Xu, Xu, Xu, Xu, Xu, Xu, Xu, Xu, Xu, Xu, Xu
Xu, Xu, Xu, Xu, Xu, Xu, Xu, Xu, Xom, Uu, Rr^Ii, Uu, Xom, Xu, Xu, Xu, Xu, Xu, Xu, Xu, Xu, Xu, Xu, Xu, Xu, Xu, Xu, Xu, Xu, Xu, Xu
