Gs^Fds, Gs^Fds, Hh^Fds, Hh^Fds, Hh^Fds, Hh^Fds, Hh^Fds, Hh^Fds, Hh^Fds, Hh^Fds, Hh^Fms, Hh^Fp, Gs^Fms, Gs^Fds, Gs^Fds, Gs^Fds, Gll^Fp, Gs^Fds, Gll^Fp, Gll^Fp, Gll^Fp, Gs^Fds, Gll^Fp, Gs^Fds, Gll^Fp, Gs^Fds, Gs^Fds, Gs^Fds, Gg, Gs^Fds, Gs^Fds, Gs^Fds, Gs^Fds, Gs^Fds, Gs^Fds, Gs^Fds, Gs^Fds, Gs^Fds, Gs^Fds, Gs^Fds, Gs^Fms, Gs^Fds
Gs^Fds, Gs^Fds, Gs^Fms, Hh^Fds, Hh^Fms, Hh^Fp, Hh^Fp, Hh^Fds, Hh, Hh^Fms, Hh^Fds, Hh^Fms, Hh, Gll^Fp, Hh^Fp, Gll^Fp, Gll^Fmw, Gll^Fp, Gll^Fp, Gll^Fmw, Gll^Fmw, Gll^Fp, Gll^Fp, Gll^Fmw, Gs^Fms, Gll^Fp, Gs^Fms, Gs^Fds, Gs^Fds, Gs^Fds, Gs^Fds, Gs^Fds, Gs^Fds, Gs^Fds, Gs^Fds, Gs^Fds, Gs^Fms, Gs^Fms, Gs^Fms, Gs^Fms, Gs^Fms, Gs^Fds
Gs^Fds, Gs^Fds, Gs^Fms, Gs^Fms, Gll^Fp, Hh, Gs^Fds, Hh^Fp, Hh^Fms, Hh, Hh^Fp, Hh^Fds, Hh^Fp, Hh^Fp, Hh^Fp, Gll^Es, Gll^Es, Gll^Fp, Gll^Fp, Gs^Fms, Gs^Fms, Gs^Fms, Gs^Fms, Gs^Fms, Gs^Fds, Gs^Fms, Gs^Fms, Gs^Fds, Gs^Fds, Gs^Fds, Gs^Fds, Gs^Fds, Gs^Fds, Gs^Fds, Gg^Efm, Gs^Fms, Gll^Fp, Gll^Fp, Gll^Fp, Gll^Fp, Gs^Fms, Gs^Fms
Gs^Fds, Gs^Fms, Gs^Fms, Gs^Fms, Gs^Fms, Gs^Fms, Gs^Fms, Gs^Fms, Gs^Fms, Hh^Fms, Gll^Fmw, Gll^Fp, Gs^Fms, Hh^Fms, Gs^Fms, Gs^Es, Gs^Fms, Gll^Fmw, Gll^Fp, Gs^Fms, Gs^Fms, Gg, Gg^Efm, Gg, Gs^Fds, Gs^Fds, Gg, Gs, Gs^Fds, Gs^Fds, Gs^Fds, Gs^Fds, Gs^Fds, Gs^Fds, Gg^Efm, Gg^Ve, Gs^Fms, Gll^Fmw, Gll^Fp, Gs^Fms, Gs^Fds, Gs^Fms
Gs^Fds, Gs^Fms, Gs^Fds, Gs^Fms, Gs^Fms, Gs^Fms, Gs^Em, Ss^Em, Gs^Fms, Hh^Fp, Gs^Fms, Gs^Fms, Gll^Fp, Gll^Fp, Gs^Fds, Gs^Fms, Gg^Ve, Gs^Fms, Gs^Fms, Gll^Fp, Gll^Fmw, Gs^Fms, Gg, Gs^Fds, Gs^Fds, Gs^Fds, Gs^Fds, Gs^Fds, Gs^Fds, Gs^Fds, Gs^Fds, Gs^Fds, Gs^Fds, Gs^Fms, Ww^Ewf, Gs^Fds, Gs^Fds, Gll^Fmw, Gll^Em, Gs^Fds, Gs^Fds, Gs^Fms
Gs^Fds, Gs^Fds, Sm, Gs^Em, Ss^Ewl, Sm, Gs^Fds, Ss, Ss, Gs^Fms, Ss, Ss, Ss^Ewl, Gs^Fms, Sm, Gs^Fds, Gs^Fds, Gs^Fds, Gs^Fds, Gs^Fms, Gll^Fp, Gll^Fp, Gs^Fds, Gs^Fds, Gs^Fds, Gs^Fds, Gg, Gs^Fds, Gs^Fds, Gg^Ve, Gs^Fds, Gg^Efm, Gg^Efm, Gg^Efm, Gll^Fp, Gs^Fms, Gll^Fp, Gll^Fp, Gll^Fp, Gll^Fmw, Gs^Fms, Gs^Fms
Gs^Fds, Gs^Fds, Gs^Fds, Ss, Ss, Gs^Fds, Gs^Fds, Gs^Fds, Ss^Ewl, Sm^Ewl, Gs^Fds, Gs^Fds, Ss, Gs^Em, Gs^Fds, Gs^Fms, Gs^Fds, Gs^Fds, Gs^Fds, Gs^Fds, Gs^Fds, Gll^Fp, Gs^Fds, Gs^Fds, Gs^Fds, Gs^Fds, Gs^Fds, Gs, Gs, Gs^Fds, Gs^Fds, Gg^Efm, Gs^Fms, Gg^Efm, Gs^Fms, Gll^Fp, Gs^Fms, Gs^Fms, Gs^Fms, Gs^Fds, Gs^Fms, Gs^Fms
Wo, Wo, Wo, Ww, Ww, Ww, Gs^Fds, Ss, Ww, Gs^Fds, Ww, Ww, Wo, Gs^Fds, Ww, Gs^Fds, Ww, Gs^Fds, Gs^Fds, Gs^Fds, Gs^Fds, Gs^Fds, Gg^Fet, Gs^Fds, Gs^Fds, Gs^Fds, Gs^Fds, Gs^Fds, Gs, Gs^Fds, Gs^Fds, Gs^Fds, Gs^Fds, Gs^Fms, Gs^Fms, Gg^Ve, Gs^Fds, Gs^Fds, Gs^Fds, Gs^Fms, Gs^Fms, Gs^Fms
Gs^Fds, Ww, Gs^Fds, Ww, Gs^Fds, Wo, Wo, Wo, Ww, Wwr, Ww, Ww, Ww, Wo, Gs^Fds, Wwr, Ww, Wwr, Ww, Wo, Ww, Gs^Fds, Gs^Fds, Gs^Fds, Gs^Fds, Gs^Fds, Ww, Gs^Fds, Gg, Gs^Fds, Gs^Fds, Gs^Fds, Gs^Fds, Gs^Fms, Gs^Fds, Gs^Fds, Gs^Fds, Hh^Fds, Hh^Fds, Gs^Fms, Gs^Fms, Gs^Fms
Gs^Fds, Gs^Fds, Re^Vct, Gs^Fds, Gs^Fds, Gs^Fds, Gs^Fds, Ww, Gs^Fds, Gs^Fds, Gs^Fds, Gs^Fds, Gs^Fds, Gs^Fds, Gs^Fds, Gs^Fds, Gs^Fds, Gs^Fds, Gs^Fds, Wo, Wo, Ww, Ww, Ww, Wo, Wo, Ww, Wwr, Ww^Bw|, Ww, Ww, Ww, Gs^Fds, Gs^Fds, Gs^Fds, Hh^Fds, Hh, Hh^Fds, Gs^Fds, Gs^Fms, Gs^Fms, Gs^Fms
Gs^Fds, Gs^Ecf, Re^Vct, 5 Ke, Ce, Gs^Fds, Gs^Fds, Gs^Fds, Gs^Fds, Gs^Fds, Gs^Fds, Gs^Fds, Gs^Fds, Gs^Fds, Gs^Fds, Gs^Fds, 4 Ke, Gs^Fds, Gg, Gs^Fds, Gs^Fds, Gs^Fds, Gs^Fds, Ww, Gs^Fds, Gs^Fds, Gs^Fds, Gs^Fds, Gs, Gs^Fds, Gs^Fds, Ww, Ww, Gs^Fds, Gs^Fds, Hh^Fds, Hh, Hh^Fds, Hh^Fds, Gs^Fds, Gs^Fms, Gs^Fms
Gs^Fds, Gs^Fds, Re, Ce, Ce, Gs^Fds, Re^Vct, Gs^Fds, Gg, Gs^Fds, Rb, Re^Edt, Re^Edt, Re^Vct, Gg, Ce, Ce, Ce, Re^Edt, Gs^Fds, Gs^Fds, Gs^Fds, Gs^Fms, Gs^Fms, Gs^Fms, Gs^Fds, Gs^Fds, Ce, Ce, Gs, Gs^Fds, Ww, Gs^Fds, Gs^Fds, Hh^Fds, Hh^Fds, Hh^Fds, Hh^Fds, Gs^Fds, Hh^Fds, Gs^Fds, Gs^Fds
Gs^Fds, Gs^Fds, Gg, Gll^Fp, Gs^Fds, Gs^Fds, Re^Edt, Re^Edt, Rb, Gs^Fds, Rb^Edt, Re^Vct, Gs^Fds, Gg, Gs^Fds, Gs^Fds, Gs^Fds, Rb^Edt, Rb^Edt, Re^Vct, Gs^Fms, Gs^Fms, Gg^Efm, Gs^Fms, Gs^Fds, Gs^Fms, Gs^Fds, 3 Ke, Ce, Gs, Gs^Fds, Ww, Wo, Gs^Fds, Hh^Fds, Hh^Fds, Hh^Fds, Hh^Fds, Hh^Fds, Gs^Fds, Gs^Fds, Gs^Fds
Gll^Fp, Gs^Fds, Gll^Fmw, Gll^Fp, Gs^Fms, Re^Vct, Gs^Fds, Re^Edt, Re, Re^Vct, Re^Edt, Re, Gs^Fds, Re^Vct, Hh^Fmw, Hh^Fp, Gs^Fms, Re^Vct, Gs^Fds, Re, Rb^Ecf, Gg, Re^Vct, Re^Edt, Re^Edt, Re^Vct, Gs^Fds, Ce, Re, Gs^Fds, Gs^Fds, Gs^Fds, Wo, Ww, Hh^Fds, Hh, Ww, Ww, Wo, Wo, Wo, Ww
Gll^Fp, Gll^Fp, Gll^Fmw, Gll^Fmw, Gs^Fms, Gs^Fds, Rb, Re^Ecf, Gs^Fds, Gs, Gs^Fds, Rb^Ecf, Gll^Fp, Gll^Fp, Hh^Fp, Hh^Fp, Gs^Fms, Gll^Fp, Gs, Gs, Gs^Fds, Gs^Fds, Gs^Fds, Gs^Fds, Gs^Ecf, Gs^Fds, Re^Vct, Re^Edt, Rb^Ecf, Re^Vct, Rb, Gg, Gs^Fds, Wo, Ww, Ww, Wwr, Hh^Fds, Hh^Fds, Wo, Hh^Fds, Wwr
Gll^Fp, Gll^Fmw, Gll^Fmw, Gs^Fms, Gs^Fds, Gs^Fds, Gs^Fms, Rb^Edt, Gs^Fms, Gs^Fds, Gs^Fds, Gs^Edt, Gs^Fds, Gs^Fms, Gg, Gll^Fp, Gs^Fms, Gs^Edt, Gs^Fms, Gs^Efm, Gs^Fds, Gs^Fds, Gll^Fmw, Gs^Fms, Gs^Fds, Gs^Fds, Gg, Re^Edt, Gs^Fds, Gs^Fms, Gs^Fds, Rb, Gs^Fds, Gs^Fds, Gs^Fds, Gs^Fds, Gll^Fp, Gs^Fds, Gs^Fms, Hh^Fp, Hh^Fmw, Gs^Fds
Gs^Fms, Gs^Fms, Gs^Fms, Re^Vct, Re, Re, Gs^Fds, Gg, Gs^Fms, Gll^Fp, Gs^Fms, Gs^Edt, Gg^Efm, Gg^Efm, Re^Vct, Gg, Gg, Gg^Edt, Gs^Fms, Gs^Fms, Gs^Fds, Gs^Fds, Gs^Fms, Gs^Fms, Gs^Edt, Gs^Edt, Gg^Efm, Gs^Fds, Gll^Fp, Gs^Fms, Gg, Re^Edt, Gll^Fp, Re, Ce, Gll^Fp, Gll^Fp, Gll^Fp, Gs^Fds, Hh^Fp, Gll^Fp, Hh^Fmw
Gs^Fds, Gs^Fms, Gg^Efm, Re^Ecf, Gs, Gs^Fds, Gs^Fms, Hh^Fms, Gs^Fms, Gs^Fms, Gs^Fms, Gg, Gs^Fms, Gg^Efm, Gs^Fds, Gs^Fds, Hh^Fds, Hh^Fds, Hh^Fp, Hh^Fds, Ww^Es, Gs^Fds, Ww^Ewf, Gg, Gs^Fds, Gs^Fds, Gs^Fds, Gs^Fms, Gll^Fp, Gll^Fp, Gll^Fp, Gs^Fds, Gs^Fds, Re^Vct, Gll^Fp, 2 Ke, Ce, Gg, Re^Vct, Gs^Fds, Hh^Fms, Hh^Fmw
Gs^Fds, Gs^Fds, Gg^Efm, Gs^Efm, Gs^Fds, Gs^Fms, Hh^Fds, Hh^Fds, Hh^Fms, Hh^Fms, Hh^Fms, Gs^Fms, Gs^Fms, Gs^Fms, Hh^Fms, Hh^Fds, Hh^Fp, Hh, Hh^Fp, Wwr, Ww^Es, Wo, Ww, Gg, Gs, Gs^Fds, Gg^Efm, Gs^Fds, Gs^Fds, Gll^Fmw, Gs^Fms, Gll^Fp, Gll^Fp, Gs^Fds, Gll^Fp, Ce, Re, Gs, Gll^Fp, Gll^Fp, Gll^Fp, Hh^Fp
Gs^Fds, Gs^Fds, Gs^Fds, Gs^Fds, Gs^Fds, Gs^Fds, Hh^Fds, Hh, Hh, Hh^Fp, Gll^Fp, Gs^Fms, Gs^Fms, Gll^Fp, Gs^Fds, Gs^Fds, Gs^Fds, Hh^Fp, Hh^Fms, Hh^Fds, Hh^Fp, Gll^Fp, Gll^Fp, Gs^Fds, Re^Ecf, Gg^Efm, Gg^Efm, Gg^Efm, Gg, Gs^Fds, Gs^Em, Gs^Emf, Gs^Fds, Gs^Fds, Gs^Fms, Gs^Fds, Re^Es, Gll^Fmw, Gll^Fmw, Gs^Fms, Gll^Fmw, Hh^Fp
Gs^Fds, Gs^Fds, Gs^Vl, Gs^Fds, Gs^Fms, Hh^Fms, Gs^Fms, Hh^Fms, Hh, Hh^Fds, Hh^Fp, Gll^Fp, Gs^Fms, Gs^Fms, Gs^Vl, Gs^Fds, Gs^Fds, Gs^Fds, Gll^Fp, Hh^Fp, Hh^Fmw, Gll^Fp, Gll^Fp, Gg, Re, Re^Vct, Gs^Fds, Gs^Fds, Gs^Fds, Gs^Fds, Gll^Fp, Gll^Fp, Gll^Fmw, Gll^Fp, Gs^Fms, Gs^Fms, Gll^Fp, Re^Feth, Gll^Fmw, Gll^Fmw, Gll^Fmw, Gll^Fp
Gs^Fds, Gs^Fds, Gs^Fds, Gs^Fds, Gs^Efm, Gs^Fms, Gs^Fms, Gs^Fds, Hh^Fds, Hh, Hh^Fds, Gs^Fms, Gs^Fds, Gs^Fds, Gs, Gs^Fds, Gs^Fds, Gs^Fds, Gs^Fds, Gs^Fds, Gs^Fds, Gll^Fmw, Gll^Fp, Gs, Gs^Fms, Gs^Fds, Gs^Fms, Gs^Fds, Gs^Fds, Gs^Fms, Gll^Fp, Gll^Fp, Gs^Fds, Gs^Fds, Gg^Edt, Gll^Fp, Re^Vct, Re^Es, Gll^Fp, Gs^Fds, Gs^Fms, Gll^Fmw
Gs^Fds, Gs^Fds, Gs^Fds, Gs, Gs^Fds, Gs, Gs^Fds, Hh^Fms, Hh^Fds, Hh, Hh^Fds, Gs^Fds, Gs^Fds, Gs, Gs^Fds, Gs^Fds, Wwf, Wwf, Gs^Fds, Gs^Fds, Gs^Fds, Gs^Fds, Gll^Fp, Gll^Fp, Gll^Fp, Gs^Fms, Gll^Fp, Gll^Fp, Gs^Fms, Gs^Fms, Gs^Fds, Gs^Fds, Gs^Fds, Gs^Fds, Gs^Fds, Gg^Edt, Re, Gs^Fds, Gs^Fms, Gs^Fms, Gll^Fp, Gll^Fp
Gs^Fds, Gs^Fds, Gs^Fds, Gs^Fds, Gs^Fds, Gs^Fds, Gs, Gs^Efm, Gs^Efm, Gs^Fds, Gs, Gs^Fds, Hh^Fds, Gs, Gs^Fds, Gs^Fds, Gs^Fds, Wwf^Ewf, Gs^Fds, Gs^Fds, Gs, Gg^Efm, Gg^Efm, Gs, Gs^Fds, Gll^Fp, Gll^Fp, Gll^Fp, Gs^Fms, Gs^Fds, Gs^Fds, Gs^Fds, Gs^Fds, Gs^Fds, Gs^Fds, Gg, Gs^Fds, Re, Gs^Fds, Gs^Fms, Gs^Fds, Gs^Fms
Gs^Fds, Gs^Fds, Gs^Fms, Gll^Fp, Gll^Fp, Gs^Fds, Gs^Fds, Gs^Vl, Gs^Fds, Gs, Gs^Fds, Hh, Hh^Fds, Gs^Fds, Hh^Fds, Gs^Fds, Wwf^Es, Wwf^Es, Wwf, Gs^Fds, Gs^Fds, Gs^Fds, Gs^Fds, Gg, Gs^Fds, Gll^Fp, Gll^Fp, Gll^Fp, Gll^Fp, Gll^Fp, Gs^Fms, Gs^Fms, Gs^Fms, Gs^Fds, Gs^Fds, Gs^Fds, Gs^Fds, Re, Gg, Gs^Fds, Gs^Fds, Gs^Fms
Gs, Gs, Gs^Fds, Gs^Fms, Gs^Fds, Gs^Fds, Gs^Fms, Gs^Fds, Gs^Fds, Gs^Fds, Gs^Fds, Gs^Fds, Hh^Fds, Hh^Fds, Gs^Fds, Hh, Hh, Gs^Fds, Gs^Fds, Gs^Fds, Gs^Fds, Gs^Fds, Gs^Fds, Gs^Fds, Gll^Fp, Gll^Fp, Gll^Fp, Gll^Fp, Gll^Fp, Gll^Fp, Gll^Fp, Gs^Fms, Gs^Fds, Gs^Fms, Gs^Fds, Gs^Fds, Gs^Fms, Gs, 1 Gg, Gg, Gs^Fds, Gs^Fds
Gs, Gs, Gs, Gs, Gs, Gs^Fds, Gs^Fds, Gs^Fds, Gs^Fds, Gs^Fds, Gs^Fds, Gs^Fds, Gs^Fds, Gs^Fds, Gs^Fds, Hh^Fds, Hh^Fds, Gs^Fds, Gs^Fds, Gs^Fds, Gs^Fds, Gs^Fds, Gs^Fds, Gll^Fp, Gg, Gll^Fp, Gll^Fp, Gll^Fp, Gll^Fp, Gll^Fp, Gll^Fp, Gll^Fp, Gll^Fp, Gll^Fp, Gg, Gs^Fds, Gs^Fds, Gs, Gg, Gg, Gs^Fds, Gs^Fds
