Gg, Gg, Gg, Gg, Gg, Gg, Rd, Rd, Ww, Wo, Wo, Wo, Ww, Ww, Ww, Gg, Gg, Gg, Gs^Fms, Gs^Fms, Gs^Fds, Gs^Fms, Gs^Fms, Gs^Fds, Gs^Fms, Gg, Gs^Fds, Gg, Gs^Fds, Gs^Fds, Gs, Gs, Gs, Re, Gg, Gg, Gg, Gg
Gg, Gg, Gg, Gg, Gs^Em, Gg, Gg, Ds, Ww, Ww, Wo, Wo, Ww, Ww, Ww, Gg, Gg, Gg, Gg, Gs^Fms, Gg^Em, Gs^Fms, Re^Gvs, Gs^Fds, Gs^Fms, Gs^Fms, Gs^Fms, Gs^Fms, Gs^Fds, Gs^Fds, Gd^Vhr, Re^Gvs, Re^Gvs, 1 Re, Gg, Gg, Gs^Fms, Gg
Gg, Gg, Gs^Fms, Gll^Fp, Gs^Fds, Gll^Fp, Gg, Gg, Ds, Ww, Wo, Wo, Ww, Ww, Ww, Gg, Gg, Gg, Gs, Gg^Em, Gs^Fms, Re^Gvs, Re^Gvs, Gs^Fms, Gs^Fds, Gs^Fms, Gs^Fms, Gs^Fds, Gs^Fms, Gs^Fds, Re^Gvs, Re^Gvs, Re, Re, Gg, Gg^Em, Gs^Fms, Gs^Fms
Gg, Gg, Gg^Em, Gll^Fp, Gs^Em, Gs^Em, Gg, Gg, Gg, Ds, Ww, Wo, Wo, Ww, Ww, Ww, Gg^Edb, Gs, Gs^Edb, Gg, Gs^Fds, Gs^Fds, Re^Gvs, Re^Gvs, Re^Gvs, Gs^Fds, Gs^Fms, Gs^Fds, Gs^Fds, Gs^Fds, Gs, Re^Gvs, Re, Gg, Gg, Gs^Fds, Gs^Fds, Gs^Fds
Gg, Gg, Gg, Gs^Fms, Gs^Eff, Gs^Eff, Gg^Eff, Gg, Gg, Ds, Ww, Ww, Wo^Edt, Ww, Ww, Ww, Wwf^Bw/r, Gs^Edb, Gg^Edb, Gg, Gg^Em, Re^Gvs, Re^Gvs, Gd^Vhr, Re^Edb, Re^Gvs, Gs, Gs^Em, Gs, Gs, Gs, Gs, Re, Gg, Gg^Em, Gs^Fds, Gs^Fms, Gs^Fms
Gs, Gs, Gs, Gs^Eff, Re^Gvs, Re^Gvs, Re^Gvs, Gs^Edb, Gs^Edb, Gg, Ds, Ww, Ww, Wo^Edt, Ww^Es, Ww^Es, Ww, Ww, Ww, Gg, Gg, Gg, Gs, Re^Gvs, Gg^Edb, Gs^Edb, Gs^Fds, Gs, Gs, Gs, Gs, Gs, Re, Gg, Gs^Fms, Gs^Fms, Gs^Fds, Gs^Fms
Re, Re, 4 Re, Re, Re, Re^Gvs, Re^Gvs, Gd^Vhr, Re^Gvs, Gg, Gg, Ds, Ww^Bw/r, Ww^Es, Ww, Ww^Edt, Wo^Edt, Ww, Ww, Ww, Ww, Gs, Gs^Edb, Gs, Gg, Gg, Gg, Gg, Gs, Gs, Gs, Re, Gs, Gg, Gs^Fds, Gs^Fms, Gs^Fds, Gs^Fds
Gg, Gs, Gs, Gs, Gs, Re, Re, Re^Gvs, Re^Gvs, Gs^Fds, Gs, Gs^Edb, Gs^Edb, Wwf, Ww, Wo, Wo, Wo, Wo, Ww, Ww^Edt, Ww, Wwf^Bw|r, Wwf, Wwf, Gg, Gg, Gg, Gs, Gs, Gs, Re, Gs, Gs^Edb, Gs^Fms, Gs^Fms, Gs^Fms, Gs^Fms
Gg, Gg^Em, Gs^Fms, Gs^Fms, Gs^Edb, Gs^Eff, Gs^Eff, Re, Re, Re^Gvs, Gs, Gg^Edb, Gg^Edb, Ds, Ds, Ww, Ww, Ww, Ww, Wo^Edt, Wo^Edt, Ww, Ww^Bw/r, Ww, Wo, Wwf, Ww, Gg, Gg, Gs, Gg, Re, Re^Gvs, Re^Gvs, Gd^Vhr, Gs^Fds, Gs^Fms, Gs^Fds
Gs^Fms, Gs^Fms, Gs^Fms, Gs^Fms, Gd^Vhr, Re^Gvs, Re^Gvs, Re^Gvs, Re, Gs, Gs, Gg, Ce, Re, Re, Ds, Re, Ww, Ww, Wo, Ww^Es, Ww^Es, Ww^Edt, Wo^Edt, Wo, Ww, Ww, Ww, Gs, Gg, Re, Re, Re, Re^Edb, Re^Gvs, Gs^Fds, Gs^Fms, Gs^Fds
Gs^Fds, Gs^Fms, Gs^Fms, Gs^Fms, Gs^Fms, Re^Gvs, Re^Gvs, Re^Gvs, Re^Gvs, Re, Rp, Ch, Re, Re, Re^Vh, Re^Edt, Re^Edt, Ce, Ce, Ww, Dd^Es, Ww^Es, Ce, Wo^Edt, Ww, Wo, Wo^Edt, Ww, Ww^Bw/, Re, Gg, Gg, Re, Re^Gvs, Re^Gvs, Gs^Fms, Re^Gvs, Gs^Fds
Gs^Fms, Gll^Fp, Gg, Gs^Fms, Gs^Fms, Re^Gvs, Re^Gvs, Re^Gvs, Ce, Ch, Rp, Rp, Rp^Vhc, Re, Re, Re^Edt, Re, Re, Re, Dd, Re^Edt, Ce, Re^Edb, Re^Edb, Ww, Wo^Edt, Ww^Es, Ww^Es, Ww, Gs, Gg, Gg, Re, Re^Gvs, Re^Gvs, Re^Gvs, Re^Gvs, Re^Gvs
Gs^Fds, Gs^Fms, Gg, Gs^Fds, Gs^Fds, Gs^Fms, Re, Re, Re, Re, Re, Rp, Re, Rp, Rp, Rp^Vhc, Rp, Rp, Rp, Rp^Vhc, Re^Edt, Re^Edt, Re, Chr, Rp^Edb, Ww^Bw/, Wo, Wo^Edt, Wo, Ww, Gg, Gg, Re, Gs^Eff, Gs^Eff, Re^Gvs, Gs^Eff, Gs^Eff
Gg, Gs^Fms, Gs^Fms, Gg, Gg, Gg, Gg, Gg, Ce, Re, Re^Vh, Re^Edt, Re^Edt, Re^Ebn, Re, Rr, Ce, Chr, Ce, Rr, Rr, Rp, Rp, Rp^Edb, Chr, Ww, Wo, Wo^Edt, Ww, Ww, Gg, Gg, Re, Gg, Gs, Gs^Eff, Gs, Gs
Gg, Gg, Gg, Gg, Gg, Gg, Gg, Gg, Chr, Re^Edt, Re, Rp, Rp, Re, Rp^Vhc, Rr, Ce, 5 Kh, Ce, Rr, Re, Re^Vhc, Re^Edt, Re, Re, Ww, Ww, Wo, Ww, Wwt, Gg, Gg, Re, Gg, Gg^Eff, Gs^Eff, Gg^Eff, Gs
Gg, Gg, Gg, Gg, Hh, Hh, Gs, Gg, Gs, Ce, Re, Rp, Re, Re, Re, Rp, Rp, Ch, Rr, Rp, Re, Re^Ebn, Re^Edt, Re^Edt, Ce, Wwt, Wo, Wo, Ww, Ww, Gg, Gg, Re, Gg, Re^Gvs, Re^Gvs, Re^Gvs, Gg^Eff
Gg, Gg, Gs, Gs, Hhd, Hh^Vhh, Hh, Gs, Gs^Edb, Gs, Gs, Chr, Re, Re^Vh, Re^Vh, Re, Re, Rr, Re, Rp^Vhc, Rp, Rp, Rp^Vhc, Re, Ce, Wwt, Wo, Wo, Wwt, Gg, Gs, Gs, Re, Gs, Gs^Vh, Re^Gvs, Re^Gvs, Re^Gvs
Hh^Fp, Hh^Fp, Hh^Fp, Gg, Re, Re, Re, Re, Gs^Edb, Gg^Edb, Gs, Chr, Ch, Re, Re^Edt, Re^Edt, Re^Edt, Rr, Rp, Re, Re, Re, Re, Re, Wwt, Ww, Wo, Wo, Ww, Gg, Re, Re, Ce, Re, Re^Gvs, Re^Gvs, Re^Gvs, Re^Gvs
Hh^Fp, Hh^Fp, Hh^Fp, Hh, Gs, Gs, Gs, Gs, Gs, Gs^Edb, Re^Gvs, Gs, Gs, Re, Re^Edb, Ch, Ch, Rr, Ch, Rp, Ch, Chr, Re, Re, Ww, Ww, Wo, Ww, Ww, Ww, Re, Ce, Ce^Ecf, Ce, Re^Gvs, Re^Gvs, Re^Gvs, Gs^Fds
Mm, Mm, Mm, Hh^Fp, Hh, Hh, Hh, Hh, Hh, Re^Gvs, Re^Gvs, Re^Gvs, Gs, Gs^Edb, Gs, Gs^Edb, Gs, Rp, Rr, Rr, Gs^Edb, Rb, Gg, Gg, Ww, Wo, Ww, Ww, Ww, Gg, Gg, Re^Edt, Re^Edt, Re^Edt, Gg, Re^Gvs, Gs^Fds, Gs^Fds
Hh, Mm, Hh, Hh, Hhd, Hh^Fp, Hh, Hh, Gs, Re^Gvs, Gs^Edb, Gs^Vh, Re^Gvs, Re^Gvs, Re^Gvs, Gs, Gs^Edb, Re, Re, Gs^Edb, Gs^Edb, Gg, Gs^Fds, Ww, Ww, Wo, Ww, Wwt, Dd, Gg, Gs^Vc, Re^Edt, Gs, Gg, Gs^Fds, Gs^Fds, Gs^Fds, Gs^Fds
Hh^Fp, Hh^Fp, Hhd, Hh^Vhh, Re, Hhd, Hhd, Hh, Hh, Gs^Edb, Gs^Edb, Re^Gvs, Re^Gvs, Re^Gvs, Re^Eff, Re^Gvs, Re^Edb, Re^Edb, Re^Gvs, Re^Gvs, Gs^Fds, Gg, Gg, Ww, Ww, Ww, Wo, Wwt, Dd, Gg, Gg, Re, Gs, Gs^Wm, Re^Gvs, Re^Gvs, Re^Gvs, Gs^Fds
Mm, Hh^Fp, Hh, Hhd, Re, Hhd, Re, Hhd, Gs^Es, Hh, Gs, Re^Gvs, Re^Gvs, Re^Eff, Re, Re^Edb, Re^Gvs, Re^Gvs, Re^Gvs, Re^Gvs, Gs^Fds, Gs^Fds, Ww, Ww, Ww, Ww, Wwt, Wwt, Gg, Gs^Fds, Gg, Re, Re, Gs, Re^Gvs, Re^Gvs, Re^Gvs, Re^Gvs
Hh, Hh, Hh, Gs^Es, Gs^Es, Re, Gs, Re, Re, Re, Gg, Gs^Edb, Gg^Edb, Re, Re^Gvs, Re^Gvs, Gs^Vl, Re^Gvs, Re^Gvs, Gs^Fds, Gs^Fds, Gg, Ww, Ww^Ewl, Ww, Ww, Wwt, Gg, Gs^Fds, Gs^Fds, Gg, Gg, Re, Re^Gvs, Re^Gvs, Re^Gvs, Re^Gvs, Re^Gvs
Hh, Hh^Fp, Hh^Fp, Hh, Hhd, Hhd, Hhd, Gs^Es, Gg^Eff, Gs^Es, Gg^Efm, Gg^Edb, Gg, Re, Gs, Re^Gvs, Re^Gvs, Re^Gvs, Gs^Fms, Gs^Fds, Gs^Fds, Gg, Ww, Wo, Wo, Wwt, Ds, Gg, Gs^Fds, Gs^Fds, Gs^Fms, Gg, Re, Gs^Vh, Re^Gvs, Re^Gvs, Gs^Fms, Re^Gvs
Hh, Hh^Fp, Hh, Hh, Gs^Es, Hh, Re^Gvs, Re^Gvs, Re^Gvs, Gg^Eff, Gg^Eff, Gg^Efm, Gg, Re^Edb, Gs^Eff, Re^Gvs, Re^Gvs, Gs^Fds, Gs^Fms, Gs^Fms, Gs^Fds, Gs^Fds, Ww, Wo, Ww, Wwt, Ds, Gg, Gs^Fds, Gs^Fds, Gg, Gg, Gg, Re, Gg^Eff, Gs^Fms, Gs^Fms, Gs^Fms
Hh, Hh, Hh, Gs^Es, Gs, Hh, Re^Gvs, Re^Gvs, Re^Gvs, Re^Gvs, Re^Gvs, Gg^Eff, Re^Eff, Re, Gs^Vl, Gg^Eff, Gg^Em, Gs^Fds, Gs^Fds, Gs^Fds, Gg, Ww, Ww, Ww, Ww, Wwf, Gs^Fds, Gg, Gg, Gg, Gg, Gg, Gg, Re, Gg, Gg^Eff, Re^Gvs, Gs^Fms
Hh, Hh, Gs^Es, Gs, Re^Gvs, Re^Gvs, Re^Gvs, Gs^Vh, Re^Gvs, Re^Gvs, Gs^Eff, Gg^Eff, Re, Gs, Gg^Efm, Gg^Efm, Gs^Fds, Gs^Fms, Gg^Em, Gg, Ww, Ww, Ww, Wwt, Wwf, Gg, Gg, Gs^Fds, Gs^Fds, Gs^Fds, Re^Gvs, Gg, Re, Re, Gs^Wm, Re^Gvs, Re^Gvs, Gg
Hh^Fp, Hh, Hh, Hh, Hh, Re^Gvs, Re^Gvs, Gs, Gs, Gs, Re, Re, Gs, Gs, Gg^Efm, Gg^Efm, Gs^Fds, Gs^Fds, Gs^Fds, Wwf, Ww, Wo, Ww, Wwf, Ds, Ds, Gg^Em, Gs^Fds, Gs^Fds, Re^Gvs, Re^Gvs, Re^Gvs, Re, Gs, Re^Gvs, Re^Gvs, Re^Gvs, Gg
Hh, Hh^Fp, Hh, Hh, Hh, Re^Gvs, Gs, Gs, Re, Re, Ce, Re, Re, Gg, Gg, Gg, Gs^Fms, Gs^Fms, Gg, Ww, Wo, Wo, Wwt, Wwf, Ds, Gg, Gg, Gs^Fms, Re^Gvs, Re^Gvs, Re^Gvs, Gs, Re, Gg, Gg, Re^Gvs, Gs^Fms, Gg
Hh, Hh, Gs, Hh, Gs, Hh, Gs, Re, Ce^Ecf, Ce, 2 Ke, Ce, Ce^Ecf, Re, Gg, Gs^Fds, Gs^Fms, Gg^Em, Wwf, Ww, Wo, Ww, Wwt, Ds, Gg^Em, Gs^Fds, Gs^Fds, Gg, Re^Gvs, Gs^Vh, Gs, Gs, Re, Gg, Gg, Gs^Fms, Gg^Em, Gs^Fds
Gg, Gs, Gg, Gs, Gg, Gg, Gg, Re, Re^Vct, Ce, Ce, Ce, Re^Vct, Re, Gg, Gs^Fds, Gg, Gs^Fds, Ww, Ww, Ww, Wwt, Gg, Gs^Fds, Gs^Fds, Gs^Fds, Gs^Fds, Gg, Re^Gvs, Re^Gvs, Gg^Eff, Re, Gg, Gg, Gg^Eff, Gg^Eff, Re^Gvs, Gg
Gg, Gg, Gg, Gg, Re^Gvs, Gg, Gg, Gs, Gs, Re^Vct, Re, Re^Vct, Gs, Gg, Re^Gvs, Gg, Gg, Gg, Ww, Ww^Ewl, Ww, Wwf, Gg, Gs^Fds, Gs^Fms, Gs^Fms, Gs^Fms, Gs^Fms, Gs, Gg^Eff, Gg, Re, Gg, Gg, Re^Gvs, Re^Gvs, Re^Gvs, Re^Gvs
Gg, Gg, Gs^Vh, Re^Gvs, Re^Gvs, Re^Gvs, Gs, Re^Vct, Re, Re, Gg, Gs, Re^Gvs, Re^Gvs, Re^Gvs, Re^Gvs, Rb, Wwf, Ww, Ww, Wwf, Ds, Gg, Gs^Fds, Gs^Fms, Gg^Em, Gg, Gs, Gs, Gg, Gg, Re, Gs, Gs, Re^Gvs, Re^Gvs, Re^Gvs, Re^Gvs
Gg, Gg, Re^Gvs, Re^Gvs, Re^Gvs, Re^Gvs, Gs, Gs, Re, Gs, Re^Vct, Gg, Re^Gvs, Re^Gvs, Re^Gvs, Gg, Wwf, Ww, Wo, Ww, Wwf, Ds, Gg, Gg, Gg, Gg, Gg, Gs, Gg, Gg^Vc, Re, Re, Gg, Gs, Gg, Gs^Vh, Re^Gvs, Re^Gvs
Gg, Gg, Gg, Re^Gvs, Re^Gvs, Re^Gvs, Gg, Re, Gs, Re, Gg, Gg^Efm, Gg^Efm, Re^Gvs, Gg, Gg, Wwf, Ww, Wo, Ww, Ds, Ds, Gg, Gg, Gg, Gg, Gg, Gg, Gg, Gg, Re, Gg, Gs^Fds, Gg^Em, Re^Gvs, Re^Gvs, Re^Gvs, Gs^Fds
Gg, Gg, Gg, Gg, Gg, Gg, Gg, Re, Gg, Gs, Gg, Gg^Efm, Gg, Gg, Gg, Gg, Wwf, Wo, Wo, Ww, Gg, Gg, Gg, Gg, Gg, Gg, Gg, Gg, Gg, Re, Gg, Gg, Gs^Fds, Gs^Fds, Gg, Re^Gvs, Gg, Gs^Fds
