Xu, Xu, Xu, Xu, Xu, Xu, Xu, Xu, Xu, Xu, Xu, Xu, Xu, Xu, Xu, Xu, Xu, Xu, Xu, Xu, Xu, Xu, Xu, Xu, Xu, Xu, Xom, Xom, Uu, Rr, Uu
Xu, Xu, Xu, Xu, Xu, Xu, Xu, Xu, Xu, Xu, Xu, Xu, Xu, Xu, Xu, Xu, Xu, Xu, Xu, Xu, Xu, Xu, Xu, Xu, Xom, Xom, Uu, Uu, Rr, Rr, Uu
Xu, Xu, Xu, Xu, Xu, Xu, Xu, Xu, Xu, Xu, Xu, Xu, Xu, Xu, Xu, Xu, Xu, Xu, Xu, Xu, Xu, Xu, Xu, Xu, Xom, Uu, Co, Co, Co, Uu, Xom
Xu, Xu, Xu, Xu, Xu, Xu, Xu, Xu, Xu, Xu, Xu, Xu, Uu^Vu, Xu, Xu, Xu, Uu^Vu, Xu, Xu, Xu, Xu, Xu, Xu, Xu, Xom, Uu, Co, 1 Ko, Co, Uu, Xom
Xu, Xu, Xu, Xu, Xu, Xu, 2 Kte, Xu, Cte, Xu, Xu, Uu, Uu, Xu, Xu, Uu, Xu, Xu, Xu, Xu, Xu, Xu, Xom, Xom, Uu, Uu, Rr, Co, Uu, Uu, Xom
Xu, Xu, Xu, Xu, Xu, Xu, Cte, Cte, Cte, Xu, Xu, Xu, Uu, Xu, Xu, Uu, Xu, Xu, Xu, Xu, Xu, Xu, Xom, Uu, Rr, Rr, Uh, Uu, Xom, Xom, Xu
Xu, Xu, Xu, Xu, Xu, Cte, Cte, Cte, Cte, Uu, Rb, Xu, Uu, Xu, Uu, Uh, Uu, Xu, Xu, Xu, Xuc, Xom, Uu, Uu, Rr, Uh, Xom, Xom, Xu, Xu, Xu
Xu, Xu, Xu, Uu^Vu, Uu, Xu, Uu, Cte, Rb, Rb, Uu, Rb, Rb, Rb, Rb, Uh, Rb, Rb, Rb, Xuc, Uh, Uh, Rr, Rr, Uu, Uu, Xom, Xu, Xu, Xu, Xu
Xu, Xu, Xu, Xu, Xu, Uu, Uu, Uu, Uu, Uu, Uu, Xu, Xu, Xu, Uu, Uu, Xu, Uu, Xuc, Rb, Uu, Rr, Uh, Uu, Xom, Xom, Xu, Xu, Xu, Xu, Xu
Xu, Xu, Uu^Vu, Xu, Rb, Rb, Xu, Xu, Uh, Xu, Xu, Xu, Xu, Uu, Xu, Xu, Xu, Xuc, Uu, Uu, Rr, Rr, Uh, Xuc, Xu, Xu, Xu, Xu, Xu, Xu, Xu
Xu, Xu, Xu, Uu, Rb, Uu, Xu, Xu, Uu, Xu, Xu, Xu, Uu, Uh, Uu, Xu, Xom, Xom, Chr, Rr, Uu, Uu, Xuc, Uu, Rb, Xu, Xu, Xu, Xu, Xu, Xu
Xu, Xu, Xu, Uu, Uh, Xu, Xu, Xu, Uu, Rb, Uu, Xu, Uu, Xu, Xu, Uu, Uh, Uh, Rr, Khr, Chr, Xuc, Xu, Uu, Uu, Rb, Uu, Xu, Uu^Vu, Xu, Xu
Xu, Xu, Uu^Vu, Uh, Uu, Xu, Xu, Xu, Xu, Rb, Rb, Uu^Vu, Xu, Xu, Xuc, Xom, Uu, Rr, Uu, Uu, Xom, Xom, Xu, Xu, Rb, Rb, Uh, Uu, Xu, Xu, Xu
Xu, Xu, Xu, Uu, Rb, Xu, Uu, Uu, Uu, Uu, Rb, Uu, Rb, Xuc, Uu, Uu, Rr, Rr, Uh, Uu, Uu, Xu, Uh, Uu, Xu, Xu, Uu, Uu, Xu, Xu, Xu
Xu, Xu, Xu, Xu, Uu, Rb, Xu, Xu, Xu, Xu, Xu, Uu, Xuc, Uh, Uu, Rr, Uu, Uh, Xom, Xom, Uu, Xu, Uu, Xu, Xu, Xu, Rb, Uu, Uu, Xu, Xu
Xu, Xu, Xu, Uu, Xu, Rb, Uu, Xu, Xu, Xu, Xu, Xom, Uu, Uh, Rr, Rr, Uu, Xuc, Uu, Xu, Uu, Uu, Xu, Xu, Xu, Xu, Rb, Uu, Xu, Uu^Vu, Xu
Xu, Xu, Xu, Uu^Vu, Xu, Uu, Uh, Uu, Uu, Uu, Uu, Uu, Uu, Rr, Uu, Uu, Xuc, Uu, Uu^Vu, Xu, Uu, Xu, Xu, Xu, Xu, Xu, Rb, Xu, Xu, Xu, Xu
Xu, Xu, Xu, Xu, Xu, Xu, Uu, Rb, Xu, Xu, Xom, Xom, Uu, Rr, Uu, Xom, Xu, Uu, Uu, Rb, Rb, Xu, Xu, Xu, Uu, Uu, Uu, Xu, Xu, Xu, Xu
Xu, Xu, Xu, Xu, Uu, Uu, Uu, Rb, Xu, Xu, Xuc, Uu, Khr, Rr, Uu, Uu, Uh, Uh, Xu, Uu, Uu, Uu, Uh, Xu, Rb, Rb, Xu, Uu, Uu^Vu, Xu, Xu
Xu, Xu, Xu, Xu, Uu^Vu, Xu, Xu, Rb, Uu, Xu, Xuc, Chr, Rr, Chr, Xom, Xom, Xu, Xu, Uu, Uu, Xu, Uu, Uh, Uu, Rb, Uu, Xu, Xu, Xu, Xu, Xu
Xu, Xu, Xu, Xu, Xu, Xu, Uu, Uh, Rb, Uu, Uh, Uu, Rr, Uu, Xom, Xu, Xu, Xu, Uh, Xu, Xu, Uu^Vu, Uu, Uu, Uu, Xu, Xu, Xu, Xu, Xu, Xu
Xu, Xu, Xu, Xu, Xu, Uu, Xu, Xu, Uu, Rb, Uh, Rr, Uu, Uu, Xom, Xu, Xu, Xu, Xu, Uu, Xu, Xu, Xu, Uu, Uu, Xu, Uu, Xu, Xu, Xu, Xu
Xu, Xu, Xu, Xu, Xu, Uu, Xu, Xu, Uu, Rb, Uu, Rr, Uu, Xom, Xu, Xu, Xu, Xu, Uu, Uu, Uu, Uu, Uu, Rb, Rb, Uu, Xu, Uu^Vu, Xu, Xu, Xu
Xu, Xu, Xu, Xu, Xu, Uu^Vu, Uu, Xu, Xom, Xuc, Uu, Rr, Uh, Xom, Xu, Uu^Vu, Xu, Xu, Uu, Xu, Xu, Xu, Xu, Uu, Rb, Uu, Xu, Xu, Xu, Xu, Xu
Xu, Xu, Xu, Xu, Xu, Xu, Rb, Xu, Xom, Uu, Rr, Rr, Uh, Xuc, Xu, Uu, Xu, Xu, Uu, Xu, Xu, Xu, Xu, Rb, Uu, Xu, Xu, Xu, Xu, Xu, Xu
Xu, Xu, Xu, Xu, Xu, Xu, Rb, Xu, Xuc, Uu, Rr, Uu, Uu, Xuc, Uu, Uu, Uh, Xu, Uu, Xu, Uu, Xu, Xu, Uu, Uu, Uu, Uu^Vu, Xu, Xu, Xu, Xu
Xu, Xu, Xu, Xu, Xu, Xu, Xu, Uh, Uu, Uu, Rr, Uu, Uu, Rb, Rb, Rb, Uu, Uh, Rb, Rb, Rb, Uu, Cte, Cte, Cte, Xu, Xu, Xu, Xu, Xu, Xu
Xu, Xu, Xu, Xu, Xu, Xu, Xu, Xuc, Uu, Rr, Uh, Uh, Xuc, Uu, Xu, Uu, Xu, Uu, Xu, Uu, Xu, Uu, Cte, Cte, Cte, Cte, Xu, Xu, Xu, Xu, Xu
Xu, Xu, Xu, Xu, Xu, Xu, Xu, Xuc, Uu, Rr, Uu, Xom, Xom, Xu, Xu, Uu, Xu, Xu, Xu, Uu, Xu, Xu, Cte, Cte, Xu, 3 Kte, Xu, Xu, Xu, Xu, Xu
Xu, Xu, Xu, Xu, Xu, Xu, Xu, Xom, Uu, Rr, Rr, Uu, Xom, Xu, Xu, Uu^Vu, Xu, Xu, Xu, Uu^Vu, Xu, Xu, Xu, Xu, Xu, Xu, Xu, Xu, Xu, Xu, Xu
Xu, Xu, Xu, Xu, Xu, Xu, Xu, Xom, Xom, Uu, Rr, Uu, Xom, Xu, Xu, Xu, Xu, Xu, Xu, Xu, Xu, Xu, Xu, Xu, Xu, Xu, Xu, Xu, Xu, Xu, Xu
Xu, Xu, Xu, Xu, Xu, Xu, Xu, Xu, Xom, Uu, Rr, Uu, Xom, Xu, Xu, Xu, Xu, Xu, Xu, Xu, Xu, Xu, Xu, Xu, Xu, Xu, Xu, Xu, Xu, Xu, Xu
Xu, Xu, Xu, Xu, Xu, Xu, Xu, Xu, Xom, Uu, Rr^Ii, Uu, Xom, Xu, Xu, Xu, Xu, Xu, Xu, Xu, Xu, Xu, Xu, Xu, Xu, Xu, Xu, Xu, Xu, Xu, Xu
